"","replicate","a","a_idx","species","links","connectances","links_per_sp","indegree","sd_gen","S_basal","S_intermediate","S_top","modularity","normalised_outdegree","normalised_indegree","potential_indegree","consumers","resources"
"1",1,2.89,1,163,202,0.015299553131864,1.23926380368098,1.23926380368098,0.90920714815771,28,92,26,0.569098651409149,1.35833333333333,1.38135593220339,NA,118,120
"2",1,4.14,2,200,287,0.0144221105527638,1.435,1.435,0.86857974616383,40,114,36,0.521476566791534,1.2987012987013,1.33333333333333,NA,150,154
"3",1,5.28,3,218,339,0.0143322200143745,1.55504587155963,1.55504587155963,0.770890078146204,33,141,38,0.503806948661804,1.25287356321839,1.21787709497207,NA,179,174
"4",1,8.76,4,241,392,0.0135546334716459,1.62655601659751,1.62655601659751,0.827113834291952,40,157,34,0.474242478609085,1.22335025380711,1.26178010471204,NA,191,197
"5",1,10.28,5,264,436,0.0125590505818643,1.65151515151515,1.65151515151515,0.752263798952361,46,173,37,0.48236945271492,1.20547945205479,1.25714285714286,NA,210,219
"6",1,10.85,6,275,481,0.0127670869276709,1.74909090909091,1.74909090909091,0.762751458898031,35,189,37,0.460032105445862,1.22767857142857,1.21681415929204,NA,226,224
"7",1,13.07,7,296,555,0.0127118644067797,1.875,1.875,0.737686105983061,36,214,41,0.447840303182602,1.184,1.16078431372549,NA,255,250
"8",1,13.85,8,308,586,0.0123947713524261,1.9025974025974,1.9025974025974,0.721859067930113,41,221,42,0.448080331087112,1.17557251908397,1.17110266159696,NA,263,262
"9",1,17.43,9,330,667,0.0122870037763655,2.02121212121212,2.02121212121212,0.711731784743735,37,249,38,0.422673970460892,1.15384615384615,1.14982578397213,NA,287,286
"10",1,20.67,10,339,705,0.0123055977378646,2.07964601769911,2.07964601769911,0.717639493183804,41,257,36,0.406981557607651,1.13758389261745,1.15699658703072,NA,293,298
"11",1,20.8,11,343,727,0.0123949329105076,2.11953352769679,2.11953352769679,0.718019804271636,46,257,35,0.431166529655457,1.13201320132013,1.17465753424658,NA,292,303
"12",1,21.5,12,349,753,0.0123999604782136,2.15759312320917,2.15759312320917,0.673266751037309,30,281,32,0.421344250440598,1.12218649517685,1.11501597444089,NA,313,311
"13",2,1.25,1,132,163,0.018852648623641,1.23484848484848,1.23484848484848,0.899771304253249,22,71,23,0.530034959316254,1.41935483870968,1.40425531914894,NA,94,93
"14",2,4.49,2,204,269,0.0129914034579349,1.31862745098039,1.31862745098039,0.909989255304983,40,108,39,0.542647361755371,1.37837837837838,1.38775510204082,NA,147,148
"15",2,6.01,3,236,327,0.0117922827262892,1.38559322033898,1.38559322033898,0.860291621572169,49,129,45,0.508959233760834,1.32584269662921,1.35632183908046,NA,174,178
"16",2,6.14,4,248,372,0.0121457489878543,1.5,1.5,0.77291067606832,37,145,49,0.543133556842804,1.36263736263736,1.27835051546392,NA,194,182
"17",2,9.03,5,277,453,0.0118505729084916,1.63537906137184,1.63537906137184,0.799793245196937,42,175,45,0.510596513748169,1.27649769585253,1.25909090909091,NA,220,217
"18",2,12.51,6,291,491,0.0116364498163289,1.6872852233677,1.6872852233677,0.74362386799183,39,195,43,0.49978643655777,1.24358974358974,1.22268907563025,NA,238,234
"19",2,13.65,7,295,517,0.0119220569583766,1.75254237288136,1.75254237288136,0.766794039096463,41,199,45,0.467422872781754,1.22916666666667,1.20901639344262,NA,244,240
"20",2,17.23,8,317,604,0.0120592580761091,1.90536277602524,1.90536277602524,0.721480268382829,37,225,46,0.445162743330002,1.20992366412214,1.16974169741697,NA,271,262
"21",2,17.8,9,324,638,0.0121927913465581,1.96913580246914,1.96913580246914,0.731240804270493,48,230,40,0.4410260617733,1.16546762589928,1.2,NA,270,278
"22",2,18.58,10,332,667,0.0121391912059113,2.00903614457831,2.00903614457831,0.687232363689963,36,256,34,0.426460355520248,1.13698630136986,1.1448275862069,NA,290,292
"23",2,19.28,11,338,695,0.0122030446157358,2.05621301775148,2.05621301775148,0.651044911911958,30,269,33,0.429819405078888,1.1304347826087,1.11920529801324,NA,302,299
"24",2,21.5,12,349,753,0.0123999604782136,2.15759312320917,2.15759312320917,0.638442993329745,26,286,33,0.412699788808823,1.11858974358974,1.09404388714734,NA,319,312
"25",3,2.89,1,163,202,0.015299553131864,1.23926380368098,1.23926380368098,0.882284113688556,25,93,28,0.5407435297966,1.38135593220339,1.34710743801653,NA,121,118
"26",3,5.11,2,224,340,0.013613068545804,1.51785714285714,1.51785714285714,0.818183651962844,31,151,32,0.544057130813599,1.23076923076923,1.22404371584699,NA,183,182
"27",3,5.89,3,241,387,0.0133817427385892,1.60580912863071,1.60580912863071,0.768555013614805,35,154,39,0.527178466320038,1.27513227513228,1.24870466321244,NA,193,189
"28",3,6.59,4,255,427,0.0131851165663116,1.67450980392157,1.67450980392157,0.836186744221901,41,168,37,0.48215040564537,1.2200956937799,1.24390243902439,NA,205,209
"29",3,9.83,5,276,476,0.0125428194993412,1.72463768115942,1.72463768115942,0.770085760900575,41,198,31,0.488787442445755,1.15481171548117,1.20524017467249,NA,229,239
"30",3,9.96,6,280,506,0.0129544290834613,1.80714285714286,1.80714285714286,0.71175674672825,34,193,43,0.480965584516525,1.23348017621145,1.1864406779661,NA,236,227
"31",3,10.53,7,289,544,0.0130718954248366,1.88235294117647,1.88235294117647,0.699983336235188,37,207,38,0.448054671287537,1.1844262295082,1.17959183673469,NA,245,244
"32",3,14.11,8,318,631,0.0125190960855505,1.98427672955975,1.98427672955975,0.727684344123983,39,243,27,0.428857922554016,1.12765957446809,1.17777777777778,NA,270,282
"33",3,17.59,9,328,667,0.0124375326322071,2.03353658536585,2.03353658536585,0.683989447587445,35,242,47,0.446953058242798,1.1841155234657,1.13494809688581,NA,289,277
"34",3,19.11,10,336,698,0.0124022743425728,2.07738095238095,2.07738095238095,0.689845622771949,43,253,36,0.426618009805679,1.13513513513514,1.16262975778547,NA,289,296
"35",3,20.25,11,339,717,0.0125150547206367,2.11504424778761,2.11504424778761,0.671858388048223,30,272,32,0.430098652839661,1.12251655629139,1.11513157894737,NA,304,302
"36",3,21.5,12,349,753,0.0123999604782136,2.15759312320917,2.15759312320917,0.676924184688884,38,270,38,0.424188196659088,1.13311688311688,1.13311688311688,NA,308,308
"37",4,0.57,1,142,160,0.0159824193387274,1.12676056338028,1.12676056338028,0.932671371129629,31,71,27,0.583066403865814,1.3921568627451,1.44897959183673,NA,98,102
"38",4,3.46,2,206,299,0.014160549372484,1.45145631067961,1.45145631067961,0.872823965293468,41,122,30,0.506314277648926,1.2638036809816,1.35526315789474,NA,152,163
"39",4,6.7,3,240,361,0.0125871687587169,1.50416666666667,1.50416666666667,0.722148369521416,39,149,41,0.513167500495911,1.27659574468085,1.26315789473684,NA,190,188
"40",4,10.18,4,258,409,0.0123367417729919,1.58527131782946,1.58527131782946,0.73890020859746,42,160,49,0.479292392730713,1.27722772277228,1.23444976076555,NA,209,202
"41",4,11.7,5,274,448,0.0119782893505521,1.63503649635036,1.63503649635036,0.807175836815752,43,182,42,0.50270801782608,1.21777777777778,1.22321428571429,NA,224,225
"42",4,12.4,6,289,486,0.0116782006920415,1.68166089965398,1.68166089965398,0.706657953630098,34,197,44,0.474967777729034,1.25108225108225,1.19917012448133,NA,241,231
"43",4,13.65,7,302,533,0.0117269146993465,1.76490066225166,1.76490066225166,0.7172304100854,42,214,44,0.465575933456421,1.1796875,1.17054263565891,NA,258,256
"44",4,14.43,8,312,565,0.0116456426745816,1.81089743589744,1.81089743589744,0.688776243981373,35,233,33,0.477421909570694,1.16417910447761,1.17293233082707,NA,266,268
"45",4,15.57,9,315,588,0.0118895966029724,1.86666666666667,1.86666666666667,0.727080581396955,37,224,45,0.457051992416382,1.20689655172414,1.17100371747212,NA,269,261
"46",4,19.15,10,335,670,0.0119760479041916,2,2,0.700726739943508,39,259,34,0.42602476477623,1.1241610738255,1.14334470989761,NA,293,298
"47",4,21.37,11,346,731,0.0122476334087292,2.11271676300578,2.11271676300578,0.660889591471173,33,271,38,0.440315634012222,1.13815789473684,1.11974110032362,NA,309,304
"48",4,21.5,12,349,753,0.0123999604782136,2.15759312320917,2.15759312320917,0.709862672731283,39,273,32,0.411640793085098,1.11858974358974,1.14426229508197,NA,305,312
"49",5,2.89,1,163,202,0.015299553131864,1.23926380368098,1.23926380368098,0.913617189213689,34,82,31,0.578705549240112,1.4051724137931,1.44247787610619,NA,113,116
"50",5,4.03,2,189,274,0.0154227175503771,1.44973544973545,1.44973544973545,0.815496801957202,32,110,36,0.556875705718994,1.33098591549296,1.29452054794521,NA,146,142
"51",5,4.81,3,216,332,0.0142980189491817,1.53703703703704,1.53703703703704,0.739413326200009,29,146,35,0.535305380821228,1.23428571428571,1.19337016574586,NA,181,175
"52",5,6.33,4,247,383,0.0126065633125967,1.55060728744939,1.55060728744939,0.779199840887273,33,153,44,0.493953227996826,1.32795698924731,1.25380710659898,NA,197,186
"53",5,7.58,5,271,438,0.0119721197211972,1.61623616236162,1.61623616236162,0.75692278128938,43,175,41,0.536482751369476,1.24311926605505,1.25462962962963,NA,216,218
"54",5,11.16,6,298,535,0.0120895758479651,1.79530201342282,1.79530201342282,0.678365621633747,29,217,43,0.452250838279724,1.21138211382114,1.14615384615385,NA,260,246
"55",5,14.4,7,314,579,0.0117824220101341,1.84394904458599,1.84394904458599,0.737820528074483,45,221,40,0.432467997074127,1.18045112781955,1.20306513409962,NA,261,266
"56",5,14.53,8,319,606,0.01194771396463,1.89968652037618,1.89968652037618,0.723545480687031,43,229,42,0.466182500123978,1.17279411764706,1.17712177121771,NA,271,272
"57",5,16.75,9,331,670,0.0122676920260002,2.02416918429003,2.02416918429003,0.666042370901505,29,258,36,0.452126353979111,1.15331010452962,1.12585034013605,NA,294,287
"58",5,20.23,10,340,700,0.0121464515009544,2.05882352941176,2.05882352941176,0.687320775835643,36,269,30,0.439102053642273,1.11475409836066,1.1371237458194,NA,299,305
"59",5,20.93,11,346,727,0.0121806148948647,2.10115606936416,2.10115606936416,0.70705883896959,36,269,33,0.42071008682251,1.1344262295082,1.14569536423841,NA,302,305
"60",5,21.5,12,349,753,0.0123999604782136,2.15759312320917,2.15759312320917,0.654673162143102,33,276,36,0.427853882312775,1.1294498381877,1.11858974358974,NA,312,309
"61",6,0.13,1,110,118,0.0196830692243536,1.07272727272727,1.07272727272727,0.991943648531114,30,42,29,0.585643470287323,1.52777777777778,1.54929577464789,NA,71,72
"62",6,1.38,2,167,227,0.0163768847846476,1.35928143712575,1.35928143712575,0.896385687610921,36,93,27,0.576083421707153,1.29457364341085,1.39166666666667,NA,120,129
"63",6,4.96,3,229,362,0.0138665440894813,1.58078602620087,1.58078602620087,0.769946725884997,38,144,42,0.476595640182495,1.25824175824176,1.23118279569892,NA,186,182
"64",6,8.44,4,250,412,0.0132369477911647,1.648,1.648,0.827455925469703,47,155,41,0.480270266532898,1.23762376237624,1.27551020408163,NA,196,202
"65",6,9.22,5,267,455,0.0128129312044155,1.70411985018727,1.70411985018727,0.781371687963282,41,169,51,0.489617168903351,1.27142857142857,1.21363636363636,NA,220,210
"66",6,10.74,6,284,494,0.0122928383018962,1.73943661971831,1.73943661971831,0.776828407757339,40,197,40,0.479222387075424,1.19831223628692,1.19831223628692,NA,237,237
"67",6,11.31,7,292,534,0.0125688462081627,1.82876712328767,1.82876712328767,0.804214134781858,50,201,33,0.486537218093872,1.16334661354582,1.24786324786325,NA,234,251
"68",6,12.45,8,298,563,0.0127223013129053,1.88926174496644,1.88926174496644,0.69316390550855,35,215,39,0.471423029899597,1.192,1.17322834645669,NA,254,250
"69",6,15.34,9,319,626,0.012342027956862,1.96238244514107,1.96238244514107,0.741629941899618,41,227,47,0.472705692052841,1.19029850746269,1.16423357664234,NA,274,268
"70",6,18.58,10,332,667,0.0121391912059113,2.00903614457831,2.00903614457831,0.76162555658396,45,241,38,0.428294509649277,1.16083916083916,1.18996415770609,NA,279,286
"71",6,19.28,11,338,695,0.0122030446157358,2.05621301775148,2.05621301775148,0.68159064051442,37,253,44,0.429669290781021,1.16551724137931,1.13804713804714,NA,297,290
"72",6,21.5,12,349,753,0.0123999604782136,2.15759312320917,2.15759312320917,0.671430563178461,34,282,28,0.398916959762573,1.10443037974684,1.1258064516129,NA,310,316
"73",7,1.52,1,120,123,0.0172268907563025,1.025,1.025,1.08405296996312,34,45,27,0.679390668869019,1.51898734177215,1.66666666666667,NA,72,79
"74",7,4.41,2,211,284,0.0128187767998195,1.34597156398104,1.34597156398104,0.829455131557573,34,118,38,0.559127628803253,1.38815789473684,1.3525641025641,NA,156,152
"75",7,5.11,3,238,343,0.0121618267560189,1.44117647058824,1.44117647058824,0.7918819191679,41,137,48,0.560761213302612,1.33707865168539,1.28648648648649,NA,185,178
"76",7,8.69,4,268,444,0.012409860808318,1.65671641791045,1.65671641791045,0.818049068625423,37,170,51,0.492459505796432,1.29468599033816,1.21266968325792,NA,221,207
"77",7,10.91,5,296,532,0.0121850664223546,1.7972972972973,1.7972972972973,0.759602494595349,43,203,39,0.473617106676102,1.20325203252033,1.22314049586777,NA,242,246
"78",7,12.16,6,309,581,0.0122094733745219,1.88025889967638,1.88025889967638,0.713649572874085,42,226,35,0.458060920238495,1.15298507462687,1.18390804597701,NA,261,268
"79",7,12.94,7,320,613,0.0120101880877743,1.915625,1.915625,0.706754907892997,35,242,35,0.483159840106964,1.15523465703971,1.15523465703971,NA,277,277
"80",7,13.51,8,323,643,0.0123646712689653,1.99071207430341,1.99071207430341,0.695338680257872,34,243,40,0.435888111591339,1.16606498194946,1.14134275618375,NA,283,277
"81",7,16.99,9,333,674,0.0121929158073736,2.02402402402402,2.02402402402402,0.680486189009009,38,252,39,0.430943995714188,1.14827586206897,1.14432989690722,NA,291,290
"82",7,17.12,10,336,696,0.0123667377398721,2.07142857142857,2.07142857142857,0.67570029679259,38,255,39,0.423432558774948,1.14675767918089,1.14285714285714,NA,294,293
"83",7,18.26,11,340,716,0.012424084678119,2.10588235294118,2.10588235294118,0.662674007110544,32,266,37,0.430853247642517,1.14093959731544,1.12211221122112,NA,303,298
"84",7,21.5,12,349,753,0.0123999604782136,2.15759312320917,2.15759312320917,0.669589340034589,35,278,35,0.405958265066147,1.11501597444089,1.11501597444089,NA,313,313
"85",8,1.14,1,114,141,0.0218910107126223,1.23684210526316,1.23684210526316,0.835275315806169,19,63,22,0.580755531787872,1.39024390243902,1.34117647058824,NA,85,82
"86",8,1.84,2,163,220,0.0166628796485647,1.34969325153374,1.34969325153374,0.87717226386371,31,87,34,0.570464849472046,1.38135593220339,1.34710743801653,NA,121,118
"87",8,5.32,3,200,293,0.0147236180904523,1.465,1.465,0.776853964499676,33,117,40,0.527251303195953,1.33333333333333,1.27388535031847,NA,157,150
"88",8,5.89,4,217,343,0.0146356033452808,1.58064516129032,1.58064516129032,0.775840821437532,36,141,34,0.519545435905457,1.22598870056497,1.24,NA,175,177
"89",8,6.02,5,227,381,0.0148532220966044,1.6784140969163,1.6784140969163,0.778166446438254,35,144,41,0.465197265148163,1.26815642458101,1.22702702702703,NA,185,179
"90",8,7.27,6,247,438,0.0144169053026563,1.77327935222672,1.77327935222672,0.767195156150303,40,170,30,0.506372392177582,1.17619047619048,1.235,NA,200,210
"91",8,10.85,7,282,531,0.0134019837964716,1.88297872340426,1.88297872340426,0.735616596383726,38,196,43,0.443329036235809,1.20512820512821,1.17991631799163,NA,239,234
"92",8,13.74,8,305,594,0.0128127696289905,1.94754098360656,1.94754098360656,0.728038416946671,36,228,33,0.420478641986847,1.15530303030303,1.16858237547893,NA,261,264
"93",8,14.52,9,314,621,0.0126371054720091,1.97770700636943,1.97770700636943,0.639612724030388,34,243,36,0.479093283414841,1.13357400722022,1.12544802867384,NA,279,277
"94",8,16.04,10,325,655,0.0124406457739791,2.01538461538462,2.01538461538462,0.722476306722327,40,251,28,0.414334803819656,1.11683848797251,1.16487455197133,NA,279,291
"95",8,19.28,11,338,695,0.0122030446157358,2.05621301775148,2.05621301775148,0.707856712987912,36,255,40,0.425469726324081,1.16151202749141,1.14576271186441,NA,295,291
"96",8,21.5,12,349,753,0.0123999604782136,2.15759312320917,2.15759312320917,0.708121385960777,38,269,36,0.392542243003845,1.13680781758958,1.14426229508197,NA,305,307
"97",9,0.78,1,137,147,0.0157793044224989,1.07299270072993,1.07299270072993,1.0580048583652,36,55,31,0.652644753456116,1.50549450549451,1.59302325581395,NA,86,91
"98",9,2.03,2,187,247,0.0142027485480996,1.32085561497326,1.32085561497326,0.813492242037386,37,102,42,0.567408084869385,1.34532374100719,1.29861111111111,NA,144,139
"99",9,5.51,3,218,310,0.0131061598951507,1.42201834862385,1.42201834862385,0.852862262700923,44,119,43,0.563111364841461,1.33742331288344,1.34567901234568,NA,162,163
"100",9,9.09,4,260,423,0.0125631125631126,1.62692307692308,1.62692307692308,0.825189873260687,46,160,44,0.512658655643463,1.2621359223301,1.27450980392157,NA,204,206
"101",9,12.33,5,285,482,0.0119100568322214,1.69122807017544,1.69122807017544,0.874227219235481,55,180,38,0.456526249647141,1.21276595744681,1.30733944954128,NA,218,235
"102",9,12.46,6,291,514,0.0121815380969309,1.76632302405498,1.76632302405498,0.759647061858294,46,192,43,0.466208815574646,1.22268907563025,1.23829787234043,NA,235,238
"103",9,13.03,7,298,549,0.0124059385804352,1.84228187919463,1.84228187919463,0.737042206042355,40,208,45,0.490469485521317,1.20161290322581,1.17786561264822,NA,253,248
"104",9,15.25,8,317,615,0.0122788803258396,1.94006309148265,1.94006309148265,0.648284022686756,32,234,46,0.478338330984116,1.19172932330827,1.13214285714286,NA,280,266
"105",9,16.77,9,326,649,0.012251061821614,1.99079754601227,1.99079754601227,0.687590749208408,35,242,41,0.420999735593796,1.17689530685921,1.15194346289753,NA,283,277
"106",9,19.66,10,340,709,0.0123026201631095,2.08529411764706,2.08529411764706,0.664301631922071,36,263,37,0.43604987859726,1.1371237458194,1.13333333333333,NA,300,299
"107",9,20.36,11,346,735,0.0123146519225936,2.1242774566474,2.1242774566474,0.651921587703994,37,266,39,0.411168456077576,1.14191419141914,1.1344262295082,NA,305,303
"108",9,21.5,12,349,753,0.0123999604782136,2.15759312320917,2.15759312320917,0.709862672731283,41,270,33,0.408687502145767,1.12218649517685,1.15181518151815,NA,303,311
"109",10,1.52,1,120,123,0.0172268907563025,1.025,1.025,1.03111234956619,30,53,20,0.649943888187408,1.44578313253012,1.64383561643836,NA,73,83
"110",10,5.1,2,202,274,0.0134968720752672,1.35643564356436,1.35643564356436,0.842232989965219,41,115,34,0.546373069286346,1.29487179487179,1.35570469798658,NA,149,156
"111",10,6.35,3,237,366,0.0130873203175284,1.54430379746835,1.54430379746835,0.782681955234244,34,158,29,0.504867255687714,1.234375,1.26737967914438,NA,187,192
"112",10,6.92,4,255,422,0.0130307241006639,1.65490196078431,1.65490196078431,0.782217786473769,37,167,40,0.495052874088287,1.25,1.23188405797101,NA,207,204
"113",10,7.62,5,271,465,0.012710127101271,1.71586715867159,1.71586715867159,0.815853670183967,46,168,50,0.485337048768997,1.26635514018692,1.24311926605505,NA,218,214
"114",10,11.1,6,283,502,0.0125805077312483,1.77385159010601,1.77385159010601,0.716498009961842,42,193,41,0.457179248332977,1.20425531914894,1.20940170940171,NA,234,235
"115",10,13.99,7,305,573,0.0123597929249353,1.87868852459016,1.87868852459016,0.709758961924917,33,228,33,0.428650856018066,1.16858237547893,1.16858237547893,NA,261,261
"116",10,17.23,8,323,618,0.0118839297732823,1.91331269349845,1.91331269349845,0.696340846592297,38,237,40,0.439914733171463,1.17454545454545,1.16606498194946,NA,277,275
"117",10,17.36,9,327,646,0.0121198476576424,1.97553516819572,1.97553516819572,0.709136771118869,48,239,37,0.419602870941162,1.13937282229965,1.18478260869565,NA,276,287
"118",10,18.14,10,335,674,0.0120475466976495,2.01194029850746,2.01194029850746,0.70498662838493,37,247,44,0.455064743757248,1.17957746478873,1.15120274914089,NA,291,284
"119",10,19.28,11,338,695,0.0122030446157358,2.05621301775148,2.05621301775148,0.665966069789433,41,258,32,0.442664414644241,1.1304347826087,1.16551724137931,NA,290,299
"120",10,21.5,12,349,753,0.0123999604782136,2.15759312320917,2.15759312320917,0.676011681389913,40,270,34,0.419869005680084,1.1258064516129,1.14802631578947,NA,304,310
"121",11,0.57,1,142,160,0.0159824193387274,1.12676056338028,1.12676056338028,1.01855894414365,36,69,22,0.631484389305115,1.35238095238095,1.56043956043956,NA,91,105
"122",11,1.35,2,185,236,0.0138660399529965,1.27567567567568,1.27567567567568,0.870576332821181,31,96,42,0.587887823581696,1.45669291338583,1.34057971014493,NA,138,127
"123",11,2.05,3,210,294,0.0133971291866029,1.4,1.4,0.791148176984257,36,119,43,0.567506611347198,1.35483870967742,1.2962962962963,NA,162,155
"124",11,3.3,4,234,364,0.0133524082021936,1.55555555555556,1.55555555555556,0.750755072306092,37,148,39,0.56714540719986,1.26486486486486,1.25133689839572,NA,187,185
"125",11,6.54,5,261,420,0.0123784261715296,1.60919540229885,1.60919540229885,0.797437024772011,47,168,41,0.508239805698395,1.21395348837209,1.2488038277512,NA,209,215
"126",11,10.12,6,293,518,0.0121090280050493,1.7679180887372,1.7679180887372,0.762208599994773,41,201,37,0.471461743116379,1.21074380165289,1.23109243697479,NA,238,242
"127",11,10.25,7,296,548,0.0125515345854329,1.85135135135135,1.85135135135135,0.69004912027515,34,215,40,0.477427899837494,1.18875502008032,1.16078431372549,NA,255,249
"128",11,13.14,8,315,610,0.0123344454554646,1.93650793650794,1.93650793650794,0.710682916272356,43,233,34,0.451451301574707,1.14130434782609,1.17977528089888,NA,267,276
"129",11,14.28,9,319,632,0.0124603221545317,1.98119122257053,1.98119122257053,0.735863291607489,35,238,42,0.41612920165062,1.16849816849817,1.13928571428571,NA,280,273
"130",11,17.76,10,329,664,0.0123063236711394,2.01823708206687,2.01823708206687,0.713362717299218,42,247,33,0.416694641113281,1.13840830449827,1.175,NA,280,289
"131",11,19.98,11,341,722,0.0124547179575643,2.11730205278592,2.11730205278592,0.677348144849147,34,277,26,0.434145301580429,1.09646302250804,1.12541254125413,NA,303,311
"132",11,21.5,12,349,753,0.0123999604782136,2.15759312320917,2.15759312320917,0.653729600667855,25,286,32,0.390962064266205,1.12218649517685,1.09748427672956,NA,318,311
"133",12,1.14,1,114,141,0.0218910107126223,1.23684210526316,1.23684210526316,0.882424459613426,19,62,23,0.564207077026367,1.40740740740741,1.34117647058824,NA,85,81
"134",12,4.72,2,198,293,0.0150233297441419,1.47979797979798,1.47979797979798,0.807683689309402,38,114,41,0.547006964683533,1.30263157894737,1.27741935483871,NA,155,152
"135",12,7.61,3,244,398,0.0134250826418404,1.63114754098361,1.63114754098361,0.783413846865543,37,161,38,0.478845208883286,1.23232323232323,1.22613065326633,NA,199,198
"136",12,10.85,4,271,449,0.0122727893945606,1.65682656826568,1.65682656826568,0.820593873577132,44,174,41,0.48321932554245,1.24311926605505,1.26046511627907,NA,215,218
"137",12,10.98,5,280,484,0.0123911930363543,1.72857142857143,1.72857142857143,0.773966945707164,40,195,33,0.481774181127548,1.19148936170213,1.2280701754386,NA,228,235
"138",12,11.55,6,291,526,0.0124659319824624,1.80756013745704,1.80756013745704,0.762732155552357,43,194,44,0.445768713951111,1.22784810126582,1.22268907563025,NA,238,237
"139",12,15.03,7,302,561,0.0123429627510946,1.85761589403974,1.85761589403974,0.741365361571738,41,213,42,0.468511760234833,1.18897637795276,1.1843137254902,NA,255,254
"140",12,17.25,8,316,625,0.0125577657223227,1.97784810126582,1.97784810126582,0.702918765655827,34,244,34,0.436555504798889,1.13669064748201,1.13669064748201,NA,278,278
"141",12,18.5,9,328,667,0.0124375326322071,2.03353658536585,2.03353658536585,0.662012747055477,38,256,32,0.434476912021637,1.1156462585034,1.13888888888889,NA,288,294
"142",12,20.02,10,336,700,0.0124378109452736,2.08333333333333,2.08333333333333,0.688713271361351,35,270,26,0.413725465536118,1.1016393442623,1.13513513513514,NA,296,305
"143",12,20.8,11,343,727,0.0123949329105076,2.11953352769679,2.11953352769679,0.689346492604997,35,268,38,0.443168669939041,1.13201320132013,1.12091503267974,NA,306,303
"144",12,21.5,12,349,753,0.0123999604782136,2.15759312320917,2.15759312320917,0.707249134897963,40,266,35,0.414224475622177,1.14052287581699,1.15946843853821,NA,301,306
"145",13,0.57,1,142,160,0.0159824193387274,1.12676056338028,1.12676056338028,0.902227100643043,29,66,35,0.633105397224426,1.49473684210526,1.40594059405941,NA,101,95
"146",13,4.15,2,212,302,0.0135026379325762,1.42452830188679,1.42452830188679,0.825514522294505,40,125,35,0.576548218727112,1.28484848484848,1.325,NA,160,165
"147",13,5.4,3,239,378,0.0132906719173025,1.581589958159,1.581589958159,0.794883255997472,49,142,41,0.50429368019104,1.25130890052356,1.30601092896175,NA,183,191
"148",13,6.18,4,260,427,0.0126819126819127,1.64230769230769,1.64230769230769,0.705536608861843,32,177,44,0.532918512821198,1.24401913875598,1.17647058823529,NA,221,209
"149",13,9.66,5,274,469,0.0125397716638593,1.71167883211679,1.71167883211679,0.761832593887524,43,188,34,0.474463671445847,1.18614718614719,1.23423423423423,NA,222,231
"150",13,11.18,6,287,506,0.0123291342803538,1.76306620209059,1.76306620209059,0.70979562802284,31,199,43,0.483160585165024,1.24782608695652,1.18595041322314,NA,242,230
"151",13,11.31,7,292,534,0.0125688462081627,1.82876712328767,1.82876712328767,0.743120819836252,37,208,35,0.475311785936356,1.19183673469388,1.20164609053498,NA,243,245
"152",13,14.2,8,314,601,0.0122301133473067,1.9140127388535,1.9140127388535,0.691738450706297,30,224,52,0.445944219827652,1.23622047244094,1.13768115942029,NA,276,254
"153",13,16.42,9,330,669,0.0123238463663996,2.02727272727273,2.02727272727273,0.717843510253438,35,249,41,0.425965368747711,1.16197183098592,1.13793103448276,NA,290,284
"154",13,19.66,10,340,709,0.0123026201631095,2.08529411764706,2.08529411764706,0.671411808806301,36,270,30,0.438987165689468,1.11111111111111,1.13333333333333,NA,300,306
"155",13,20.36,11,346,735,0.0123146519225936,2.1242774566474,2.1242774566474,0.696692763593175,38,272,32,0.402176946401596,1.11612903225806,1.13815789473684,NA,304,310
"156",13,21.5,12,349,753,0.0123999604782136,2.15759312320917,2.15759312320917,0.709862672731283,41,270,34,0.430055767297745,1.12218649517685,1.14802631578947,NA,304,311
"157",14,2.22,1,171,214,0.0147230822153423,1.25146198830409,1.25146198830409,0.89272439011892,42,82,36,0.628144383430481,1.37903225806452,1.44915254237288,NA,118,124
"158",14,2.35,2,195,268,0.0141686492201956,1.37435897435897,1.37435897435897,0.889102962934369,36,108,33,0.531605005264282,1.35416666666667,1.38297872340426,NA,141,144
"159",14,5.24,3,237,381,0.0136236859043124,1.60759493670886,1.60759493670886,0.834275430374108,42,142,42,0.477673053741455,1.28804347826087,1.28804347826087,NA,184,184
"160",14,8.48,4,258,437,0.0131813108919253,1.6937984496124,1.6937984496124,0.809207446378403,41,168,41,0.478331536054611,1.23444976076555,1.23444976076555,NA,209,209
"161",14,9.62,5,264,462,0.0133079847908745,1.75,1.75,0.704275318809193,36,177,48,0.484843850135803,1.23943661971831,1.17333333333333,NA,225,213
"162",14,10.87,6,282,513,0.012947679260998,1.81914893617021,1.81914893617021,0.673472430286827,32,209,36,0.465679854154587,1.1701244813278,1.15102040816327,NA,245,241
"163",14,11.44,7,291,549,0.0130110202630643,1.88659793814433,1.88659793814433,0.709272516280048,37,213,37,0.485434651374817,1.164,1.164,NA,250,250
"164",14,12.22,8,299,577,0.0129514489012592,1.92976588628763,1.92976588628763,0.748370351357194,43,217,35,0.441299796104431,1.15,1.18650793650794,NA,252,260
"165",14,13.74,9,312,616,0.0126968422788358,1.97435897435897,1.97435897435897,0.699861186368006,36,233,39,0.44148862361908,1.15985130111524,1.14705882352941,NA,272,269
"166",14,14.44,10,318,643,0.0127571771521536,2.02201257861635,2.02201257861635,0.716220945036755,43,230,43,0.449297249317169,1.16483516483516,1.16483516483516,NA,273,273
"167",14,17.92,11,329,675,0.0125101934909927,2.0516717325228,2.0516717325228,0.665846388864217,38,255,32,0.440051585435867,1.12286689419795,1.14634146341463,NA,287,293
"168",14,21.5,12,349,753,0.0123999604782136,2.15759312320917,2.15759312320917,0.669589340034589,33,277,34,0.421785175800323,1.1258064516129,1.12218649517685,NA,311,310
"169",15,2.22,1,171,214,0.0147230822153423,1.25146198830409,1.25146198830409,0.818080514036371,28,87,43,0.584483325481415,1.48695652173913,1.31538461538462,NA,130,115
"170",15,5.8,2,237,355,0.0126939855538869,1.49789029535865,1.49789029535865,0.805134797640246,36,152,38,0.514548718929291,1.26063829787234,1.24736842105263,NA,190,188
"171",15,6.5,3,256,403,0.0123468137254902,1.57421875,1.57421875,0.731984344285562,33,165,45,0.482174634933472,1.29292929292929,1.21904761904762,NA,210,198
"172",15,7.64,4,264,440,0.0126742712294043,1.66666666666667,1.66666666666667,0.807757069229192,43,175,35,0.520717918872833,1.21100917431193,1.25714285714286,NA,210,218
"173",15,7.77,5,273,474,0.0127666451195863,1.73626373626374,1.73626373626374,0.738344345381862,42,192,31,0.490544140338898,1.16666666666667,1.22421524663677,NA,223,234
"174",15,10.66,6,293,549,0.0128336995651971,1.87372013651877,1.87372013651877,0.704167075024371,33,213,39,0.465039938688278,1.19105691056911,1.16269841269841,NA,252,246
"175",15,12.18,7,305,588,0.0126833477135462,1.92786885245902,1.92786885245902,0.714253945702921,35,232,33,0.449099630117416,1.14232209737828,1.15094339622642,NA,265,267
"176",15,15.66,8,314,621,0.0126371054720091,1.97770700636943,1.97770700636943,0.698226418073415,38,239,32,0.46313413977623,1.13357400722022,1.15867158671587,NA,271,277
"177",15,16.23,9,320,652,0.0127742946708464,2.0375,2.0375,0.673973633153362,35,244,36,0.414624392986298,1.14695340501792,1.14285714285714,NA,280,279
"178",15,17.48,10,332,690,0.0125577840061151,2.07831325301205,2.07831325301205,0.693677817661447,38,249,38,0.420301407575607,1.15679442508711,1.15679442508711,NA,287,287
"179",15,20.72,11,342,727,0.0124676304642349,2.12573099415205,2.12573099415205,0.74079039199134,32,259,44,0.396161824464798,1.17525773195876,1.12871287128713,NA,303,291
"180",15,21.5,12,349,753,0.0123999604782136,2.15759312320917,2.15759312320917,0.696696948120763,40,263,42,0.404878973960876,1.15181518151815,1.14426229508197,NA,305,303
"181",16,0.7,1,144,151,0.0146658896658897,1.04861111111111,1.04861111111111,1.01081349627327,38,58,32,0.650607466697693,1.5,1.6,NA,90,96
"182",16,3.59,2,200,282,0.0141708542713568,1.41,1.41,0.826687995112946,37,114,38,0.583899259567261,1.32450331125828,1.31578947368421,NA,152,151
"183",16,7.17,3,247,399,0.0131332082551595,1.61538461538462,1.61538461538462,0.877652838807089,40,163,32,0.482236295938492,1.21674876847291,1.26666666666667,NA,195,203
"184",16,9.39,4,280,491,0.0125704045058884,1.75357142857143,1.75357142857143,0.714512321140441,36,192,49,0.481846392154694,1.2280701754386,1.16182572614108,NA,241,228
"185",16,10.53,5,287,521,0.01269462245072,1.81533101045296,1.81533101045296,0.707081668799264,37,210,35,0.468503296375275,1.16194331983806,1.17142857142857,NA,245,247
"186",16,14.01,6,300,560,0.0124860646599777,1.86666666666667,1.86666666666667,0.725691308498565,34,221,37,0.449684262275696,1.17647058823529,1.16279069767442,NA,258,255
"187",16,17.25,7,313,600,0.0122880314573605,1.91693290734824,1.91693290734824,0.697542567807251,35,230,43,0.455456912517548,1.1811320754717,1.14652014652015,NA,273,265
"188",16,17.38,8,317,627,0.0125184682346364,1.97791798107256,1.97791798107256,0.752938148411161,50,229,33,0.42986649274826,1.13620071684588,1.20992366412214,NA,262,279
"189",16,18.16,9,326,658,0.012420953279849,2.01840490797546,2.01840490797546,0.727050850664562,39,246,38,0.422483175992966,1.14385964912281,1.14788732394366,NA,284,285
"190",16,19.68,10,335,689,0.0123156671731165,2.05671641791045,2.05671641791045,0.695754080319247,39,253,39,0.428765505552292,1.1472602739726,1.1472602739726,NA,292,292
"191",16,20.25,11,339,717,0.0125150547206367,2.11504424778761,2.11504424778761,0.690308443690031,37,253,44,0.419491559267044,1.16896551724138,1.14141414141414,NA,297,290
"192",16,21.5,12,349,753,0.0123999604782136,2.15759312320917,2.15759312320917,0.738836924587832,41,263,38,0.399684131145477,1.14802631578947,1.15946843853821,NA,301,304
"193",17,0.13,1,110,118,0.0196830692243536,1.07272727272727,1.07272727272727,0.899198014148102,27,46,29,0.633725881576538,1.50684931506849,1.46666666666667,NA,75,73
"194",17,3.71,2,202,281,0.0138416826757303,1.39108910891089,1.39108910891089,0.851631295550832,39,121,31,0.568464159965515,1.2625,1.32894736842105,NA,152,160
"195",17,6.6,3,245,389,0.0130143860823018,1.58775510204082,1.58775510204082,0.799684116508393,41,152,41,0.511095643043518,1.26943005181347,1.26943005181347,NA,193,193
"196",17,7.3,4,259,435,0.0130196641824549,1.67953667953668,1.67953667953668,0.776133969470622,41,170,40,0.494104862213135,1.22748815165877,1.23333333333333,NA,210,211
"197",17,8.08,5,275,477,0.0126609157266092,1.73454545454545,1.73454545454545,0.770671705444151,50,176,42,0.487531244754791,1.21681415929204,1.26146788990826,NA,218,226
"198",17,11.56,6,288,518,0.0125338753387534,1.79861111111111,1.79861111111111,0.752915932088019,46,198,35,0.488038688898087,1.18032786885246,1.23605150214592,NA,233,244
"199",17,12.7,7,296,550,0.0125973431058177,1.85810810810811,1.85810810810811,0.677890815262314,32,222,38,0.47546112537384,1.16535433070866,1.13846153846154,NA,260,254
"200",17,14.92,8,314,618,0.0125760566533038,1.96815286624204,1.96815286624204,0.693836238711547,36,236,37,0.442373394966125,1.15441176470588,1.15018315018315,NA,273,272
"201",17,15.49,9,319,646,0.0127363419490941,2.02507836990596,2.02507836990596,0.672506921275848,27,249,38,0.432575076818466,1.15579710144928,1.11149825783972,NA,287,276
"202",17,18.73,10,331,686,0.0125606518355763,2.07250755287009,2.07250755287009,0.67208628311435,34,256,37,0.417763829231262,1.14137931034483,1.12969283276451,NA,293,290
"203",17,20.25,11,339,717,0.0125150547206367,2.11504424778761,2.11504424778761,0.682600783784973,39,258,39,0.423474341630936,1.14141414141414,1.14141414141414,NA,297,297
"204",17,21.5,12,349,753,0.0123999604782136,2.15759312320917,2.15759312320917,0.678745510997236,36,271,40,0.420530378818512,1.13680781758958,1.12218649517685,NA,311,307
"205",18,2.22,1,171,214,0.0147230822153423,1.25146198830409,1.25146198830409,0.925770747198433,33,93,29,0.569165468215942,1.35714285714286,1.40163934426229,NA,122,126
"206",18,5.46,2,206,292,0.0138290314941984,1.41747572815534,1.41747572815534,0.842114318274218,41,118,36,0.57120817899704,1.29559748427673,1.33766233766234,NA,154,159
"207",18,5.59,3,222,340,0.0138600138600139,1.53153153153153,1.53153153153153,0.762364302599712,31,147,33,0.520631551742554,1.24719101123596,1.23333333333333,NA,180,178
"208",18,9.07,4,245,393,0.0131482101037136,1.60408163265306,1.60408163265306,0.784706505467289,42,155,38,0.512088119983673,1.24365482233503,1.26943005181347,NA,193,197
"209",18,11.96,5,276,482,0.0127009222661397,1.7463768115942,1.7463768115942,0.75828101653194,39,191,33,0.477139711380005,1.2,1.23214285714286,NA,224,230
"210",18,13.48,6,291,520,0.0123237350396966,1.78694158075601,1.78694158075601,0.76419664080336,35,210,38,0.470151603221893,1.18775510204082,1.17338709677419,NA,248,245
"211",18,14.18,7,300,552,0.0123076923076923,1.84,1.84,0.76364292330695,43,213,40,0.47050741314888,1.171875,1.18577075098814,NA,253,256
"212",18,15.43,8,313,596,0.0122061112476448,1.90415335463259,1.90415335463259,0.722870160193346,39,236,31,0.456453323364258,1.13818181818182,1.17228464419476,NA,267,275
"213",18,19.01,9,334,680,0.0122277966589344,2.03592814371257,2.03592814371257,0.721019864311127,37,254,39,0.401536554098129,1.14776632302405,1.13993174061433,NA,293,291
"214",18,20.15,10,337,699,0.0123463331920305,2.07418397626113,2.07418397626113,0.703364202652152,37,262,31,0.459369689226151,1.12709030100334,1.15017064846416,NA,293,299
"215",18,20.72,11,342,727,0.0124676304642349,2.12573099415205,2.12573099415205,0.691867715919228,36,261,41,0.387144327163696,1.15151515151515,1.13245033112583,NA,302,297
"216",18,21.5,12,349,753,0.0123999604782136,2.15759312320917,2.15759312320917,0.655615365646308,24,281,40,0.406071126461029,1.14426229508197,1.08722741433022,NA,321,305
"217",19,0.78,1,137,147,0.0157793044224989,1.07299270072993,1.07299270072993,0.936314416999137,29,63,27,0.631311058998108,1.48913043478261,1.52222222222222,NA,90,92
"218",19,3,2,199,277,0.0140601999898482,1.39195979899497,1.39195979899497,0.793293239398494,40,110,42,0.561261057853699,1.32666666666667,1.30921052631579,NA,152,150
"219",19,3.7,3,222,333,0.0135746606334842,1.5,1.5,0.794019881139032,33,139,42,0.535269439220428,1.2906976744186,1.22651933701657,NA,181,172
"220",19,4.27,4,242,383,0.0131339803161757,1.58264462809917,1.58264462809917,0.790115649506152,37,163,34,0.520454823970795,1.21,1.22842639593909,NA,197,200
"221",19,7.16,5,268,470,0.0131365643691654,1.75373134328358,1.75373134328358,0.770687443460679,34,183,41,0.46259617805481,1.23502304147465,1.19642857142857,NA,224,217
"222",19,8.3,6,273,495,0.0133322559793148,1.81318681318681,1.81318681318681,0.71992125222805,31,193,42,0.495620846748352,1.21875,1.16170212765957,NA,235,224
"223",19,11.54,7,290,539,0.0128624269180289,1.85862068965517,1.85862068965517,0.72254342185056,36,215,32,0.448478758335114,1.15537848605578,1.17408906882591,NA,247,251
"224",19,15.02,8,303,577,0.0126111948943239,1.9042904290429,1.9042904290429,0.713949938286284,32,232,30,0.465548187494278,1.14772727272727,1.15648854961832,NA,262,264
"225",19,16.27,9,314,617,0.0125557070470686,1.96496815286624,1.96496815286624,0.723505667841862,33,237,35,0.450443834066391,1.16296296296296,1.15441176470588,NA,272,270
"226",19,19.85,10,338,700,0.0122908363036188,2.07100591715976,2.07100591715976,0.688058977078089,33,259,41,0.416778564453125,1.15753424657534,1.12666666666667,NA,300,292
"227",19,21.37,11,346,731,0.0122476334087292,2.11271676300578,2.11271676300578,0.653975338864246,36,268,37,0.41717866063118,1.13815789473684,1.1344262295082,NA,305,304
"228",19,21.5,12,349,753,0.0123999604782136,2.15759312320917,2.15759312320917,0.65937071624081,27,280,37,0.416460782289505,1.13680781758958,1.10094637223975,NA,317,307
"229",20,1.52,1,120,123,0.0172268907563025,1.025,1.025,0.933397080629956,17,53,30,0.612928807735443,1.71428571428571,1.44578313253012,NA,83,70
"230",20,2.22,2,193,223,0.0120358376511226,1.15544041450777,1.15544041450777,0.925033734028443,41,91,43,0.613253831863403,1.46212121212121,1.44029850746269,NA,134,132
"231",20,4.44,3,235,337,0.0122567739589016,1.43404255319149,1.43404255319149,0.867003582321975,45,135,44,0.514097154140472,1.30555555555556,1.31284916201117,NA,179,180
"232",20,4.57,4,245,380,0.0127132820341251,1.55102040816327,1.55102040816327,0.792451065236933,40,151,45,0.508743107318878,1.28272251308901,1.25,NA,196,191
"233",20,5.82,5,265,442,0.0126357918810749,1.66792452830189,1.66792452830189,0.760505433229805,39,176,39,0.492329686880112,1.23255813953488,1.23255813953488,NA,215,215
"234",20,6.39,6,273,481,0.0129551820728291,1.76190476190476,1.76190476190476,0.699815212149804,39,188,41,0.476162821054459,1.20264317180617,1.19213973799127,NA,229,227
"235",20,9.63,7,289,528,0.0126874279123414,1.82698961937716,1.82698961937716,0.703192432487323,33,214,38,0.483429849147797,1.17004048582996,1.1468253968254,NA,252,247
"236",20,13.11,8,303,565,0.0123489170109064,1.86468646864686,1.86468646864686,0.692420324347218,34,233,30,0.467950522899628,1.13483146067416,1.15209125475285,NA,263,267
"237",20,16.69,9,326,650,0.0122699386503067,1.99386503067485,1.99386503067485,0.714711045119268,38,246,36,0.444886386394501,1.14788732394366,1.15602836879433,NA,282,284
"238",20,17.83,10,329,670,0.0124175253910594,2.03647416413374,2.03647416413374,0.70991710465072,38,245,41,0.436110496520996,1.16254416961131,1.15034965034965,NA,286,283
"239",20,20.72,11,342,727,0.0124676304642349,2.12573099415205,2.12573099415205,0.732863443471873,39,261,36,0.443017274141312,1.14,1.15151515151515,NA,297,300
"240",20,21.5,12,349,753,0.0123999604782136,2.15759312320917,2.15759312320917,0.652784675331965,32,274,40,0.423912107944489,1.14052287581699,1.11146496815287,NA,314,306
"241",21,1.52,1,120,123,0.0172268907563025,1.025,1.025,1.05412680416198,32,42,32,0.64211118221283,1.62162162162162,1.62162162162162,NA,74,74
"242",21,5,2,182,223,0.0135389472406047,1.22527472527473,1.22527472527473,0.89519988380575,35,95,31,0.595819354057312,1.4,1.44444444444444,NA,126,130
"243",21,5.7,3,221,291,0.0119703825586179,1.31674208144796,1.31674208144796,0.935511994031119,51,114,40,0.559151411056519,1.33939393939394,1.43506493506493,NA,154,165
"244",21,8.94,4,252,355,0.011224941503826,1.40873015873016,1.40873015873016,0.853550627545515,47,146,44,0.542816877365112,1.30569948186528,1.32631578947368,NA,190,193
"245",21,11.83,5,281,443,0.0112608032536858,1.57651245551601,1.57651245551601,0.843049007378447,43,179,47,0.511108338832855,1.26576576576577,1.24336283185841,NA,226,222
"246",21,14.05,6,296,519,0.0118873110398534,1.75337837837838,1.75337837837838,0.768048888517484,44,197,45,0.465449720621109,1.22821576763485,1.22314049586777,NA,242,241
"247",21,15.19,7,299,544,0.0122107247873224,1.81939799331104,1.81939799331104,0.789106920931013,40,203,50,0.4539495408535,1.23045267489712,1.18181818181818,NA,253,243
"248",21,16.44,8,312,590,0.0121609365982356,1.89102564102564,1.89102564102564,0.72110259494046,45,227,36,0.477854132652283,1.14705882352941,1.18631178707224,NA,263,272
"249",21,17.01,9,317,622,0.0124186399393044,1.96214511041009,1.96214511041009,0.648436679138278,33,234,42,0.443574815988541,1.187265917603,1.14855072463768,NA,276,267
"250",21,17.14,10,321,648,0.0126168224299065,2.01869158878505,2.01869158878505,0.737819126189838,35,236,43,0.448413193225861,1.18450184501845,1.1505376344086,NA,279,271
"251",21,20.72,11,342,727,0.0124676304642349,2.12573099415205,2.12573099415205,0.683373512979584,35,272,33,0.405305117368698,1.11400651465798,1.12131147540984,NA,305,307
"252",21,21.5,12,349,753,0.0123999604782136,2.15759312320917,2.15759312320917,0.683277587005728,34,277,36,0.41044494509697,1.12218649517685,1.11501597444089,NA,313,311
"253",22,3.24,1,156,170,0.0140612076095947,1.08974358974359,1.08974358974359,0.951775237250662,34,74,33,0.660380661487579,1.44444444444444,1.45794392523365,NA,107,108
"254",22,3.81,2,193,247,0.0133311744386874,1.27979274611399,1.27979274611399,0.917790377337596,43,102,35,0.58865088224411,1.33103448275862,1.40875912408759,NA,137,145
"255",22,4.59,3,220,307,0.0127438771274388,1.39545454545455,1.39545454545455,0.825480191685099,40,130,37,0.548233926296234,1.29411764705882,1.31736526946108,NA,167,170
"256",22,5.84,4,246,379,0.0125767380122781,1.54065040650407,1.54065040650407,0.828419246096147,34,156,39,0.491005331277847,1.29473684210526,1.26153846153846,NA,195,190
"257",22,6.54,5,261,420,0.0123784261715296,1.60919540229885,1.60919540229885,0.823100067163859,50,159,42,0.491785675287247,1.2488038277512,1.29850746268657,NA,201,209
"258",22,8.06,6,278,461,0.0119730930057398,1.65827338129496,1.65827338129496,0.80900691890877,46,181,39,0.510756611824036,1.22466960352423,1.26363636363636,NA,220,227
"259",22,10.95,7,299,530,0.011896478193531,1.77257525083612,1.77257525083612,0.745610823250262,39,213,39,0.471835196018219,1.18650793650794,1.18650793650794,NA,252,252
"260",22,11.08,8,302,558,0.012276957602693,1.8476821192053,1.8476821192053,0.748033275731253,44,213,38,0.490254163742065,1.17509727626459,1.20318725099602,NA,251,257
"261",22,12.22,9,306,581,0.0124504446587378,1.89869281045752,1.89869281045752,0.700705843494594,33,228,37,0.474191308021545,1.17241379310345,1.15471698113208,NA,265,261
"262",22,14.44,10,318,643,0.0127571771521536,2.02201257861635,2.02201257861635,0.658993717063259,31,239,45,0.439808785915375,1.17777777777778,1.11971830985915,NA,284,270
"263",22,18.02,11,340,723,0.0125455491931286,2.12647058823529,2.12647058823529,0.644914145264893,30,275,33,0.440727442502975,1.11475409836066,1.1038961038961,NA,308,305
"264",22,21.5,12,349,753,0.0123999604782136,2.15759312320917,2.15759312320917,0.734647676732823,41,263,41,0.377480745315552,1.14802631578947,1.14802631578947,NA,304,304
"265",23,3.48,1,144,158,0.0153457653457653,1.09722222222222,1.09722222222222,0.91024092967606,29,66,31,0.628685295581818,1.51578947368421,1.48453608247423,NA,97,95
"266",23,3.61,2,165,210,0.0155210643015521,1.27272727272727,1.27272727272727,0.842868954030514,35,89,29,0.594773173332214,1.33064516129032,1.39830508474576,NA,118,124
"267",23,5.83,3,222,332,0.0135338958868371,1.4954954954955,1.4954954954955,0.773204167849049,36,130,43,0.540708065032959,1.33734939759036,1.28323699421965,NA,173,166
"268",23,9.41,4,266,446,0.0126542772024401,1.67669172932331,1.67669172932331,0.752801776289209,36,171,46,0.480602353811264,1.28502415458937,1.2258064516129,NA,217,207
"269",23,10.55,5,273,477,0.0128474466709761,1.74725274725275,1.74725274725275,0.767826282823613,38,195,37,0.524489164352417,1.17167381974249,1.17672413793103,NA,232,233
"270",23,13.44,6,296,551,0.0126202473660101,1.86148648648649,1.86148648648649,0.769523620914116,42,214,36,0.452941566705704,1.15625,1.184,NA,250,256
"271",23,14.01,7,303,584,0.0127641903263174,1.92739273927393,1.92739273927393,0.687589361420587,38,222,42,0.463781625032425,1.16538461538462,1.14772727272727,NA,264,260
"272",23,14.71,8,311,618,0.0128202468623587,1.98713826366559,1.98713826366559,0.695397377743487,31,232,39,0.433599323034286,1.18250950570342,1.14760147601476,NA,271,263
"273",23,15.49,9,319,646,0.0127363419490941,2.02507836990596,2.02507836990596,0.665630384377059,36,241,37,0.414662957191467,1.15162454873646,1.14748201438849,NA,278,277
"274",23,16.74,10,331,682,0.0124874118831823,2.06042296072508,2.06042296072508,0.710284472517693,44,244,40,0.42362254858017,1.14930555555556,1.16549295774648,NA,284,288
"275",23,18.26,11,340,716,0.012424084678119,2.10588235294118,2.10588235294118,0.688277295063908,37,267,34,0.422402143478394,1.11842105263158,1.12956810631229,NA,301,304
"276",23,21.5,12,349,753,0.0123999604782136,2.15759312320917,2.15759312320917,0.691360460884349,35,275,32,0.419510960578918,1.1258064516129,1.13680781758958,NA,307,310
"277",24,0.7,1,144,151,0.0146658896658897,1.04861111111111,1.04861111111111,1.0539351976542,32,58,33,0.593745827674866,1.6,1.58241758241758,NA,91,90
"278",24,2.22,2,193,223,0.0120358376511226,1.15544041450777,1.15544041450777,0.945885774525443,53,91,38,0.654145479202271,1.34027777777778,1.49612403100775,NA,129,144
"279",24,5.11,3,238,343,0.0121618267560189,1.44117647058824,1.44117647058824,0.819615779191214,44,147,32,0.539647579193115,1.24607329842932,1.32960893854749,NA,179,191
"280",24,5.68,4,250,396,0.0127228915662651,1.584,1.584,0.757761663666237,38,167,38,0.531852602958679,1.21951219512195,1.21951219512195,NA,205,205
"281",24,6.46,5,265,434,0.0124070897655803,1.6377358490566,1.6377358490566,0.843012991577494,44,168,45,0.503403127193451,1.25,1.24413145539906,NA,213,212
"282",24,9.94,6,280,474,0.0121351766513057,1.69285714285714,1.69285714285714,0.7380986347277,39,185,46,0.49201962351799,1.25,1.21212121212121,NA,231,224
"283",24,13.52,7,304,564,0.0122459614382491,1.85526315789474,1.85526315789474,0.704504135867622,32,226,41,0.473199933767319,1.17829457364341,1.13857677902622,NA,267,258
"284",24,15.74,8,321,635,0.012363707165109,1.97819314641745,1.97819314641745,0.738444963488768,44,231,39,0.452277302742004,1.16727272727273,1.18888888888889,NA,270,275
"285",24,16.99,9,333,674,0.0121929158073736,2.02402402402402,2.02402402402402,0.690141882543331,34,251,38,0.40415745973587,1.16842105263158,1.1522491349481,NA,289,285
"286",24,17.12,10,336,696,0.0123667377398721,2.07142857142857,2.07142857142857,0.667412813558225,30,263,38,0.42296290397644,1.14675767918089,1.11627906976744,NA,301,293
"287",24,20.36,11,346,735,0.0123146519225936,2.1242774566474,2.1242774566474,0.670380719274498,36,269,34,0.437199324369431,1.1344262295082,1.14191419141914,NA,303,305
"288",24,21.5,12,349,753,0.0123999604782136,2.15759312320917,2.15759312320917,0.72107854903015,27,285,32,0.38528311252594,1.11858974358974,1.10094637223975,NA,317,312
"289",25,1.52,1,120,123,0.0172268907563025,1.025,1.025,1.09140630486275,30,45,30,0.661775350570679,1.6,1.6,NA,75,75
"290",25,2.66,2,164,215,0.0160855903037558,1.3109756097561,1.3109756097561,0.884448716994075,30,85,31,0.542931318283081,1.42608695652174,1.41379310344828,NA,116,115
"291",25,3.91,3,207,301,0.0141175367009052,1.45410628019324,1.45410628019324,0.826186181158708,39,116,44,0.552355885505676,1.33548387096774,1.29375,NA,160,155
"292",25,4.61,4,234,356,0.0130589486812663,1.52136752136752,1.52136752136752,0.830976511291265,40,148,36,0.523517429828644,1.24468085106383,1.27173913043478,NA,184,188
"293",25,7.85,5,262,412,0.0120499546664327,1.57251908396947,1.57251908396947,0.812551450654853,40,166,42,0.499154537916183,1.27184466019417,1.25961538461538,NA,208,206
"294",25,11.33,6,276,453,0.0119367588932806,1.64130434782609,1.64130434782609,0.768472209843008,43,186,38,0.493294656276703,1.20524017467249,1.23214285714286,NA,224,229
"295",25,14.91,7,300,545,0.0121516164994426,1.81666666666667,1.81666666666667,0.755285612626351,51,200,41,0.458892345428467,1.19521912350598,1.2448132780083,NA,241,251
"296",25,17.8,8,319,608,0.0119871453638532,1.90595611285266,1.90595611285266,0.694497665421435,36,236,40,0.445297658443451,1.17279411764706,1.15579710144928,NA,276,272
"297",25,18.37,9,326,641,0.0121000471920717,1.96625766871166,1.96625766871166,0.689080577938241,30,249,40,0.438351929187775,1.16845878136201,1.1280276816609,NA,289,279
"298",25,18.5,10,330,668,0.0123054250713825,2.02424242424242,2.02424242424242,0.701713989912425,43,249,34,0.420440137386322,1.13013698630137,1.1660777385159,NA,283,292
"299",25,20.72,11,342,727,0.0124676304642349,2.12573099415205,2.12573099415205,0.697473049699732,36,258,43,0.402119874954224,1.16326530612245,1.13621262458472,NA,301,294
"300",25,21.5,12,349,753,0.0123999604782136,2.15759312320917,2.15759312320917,0.735487435222403,37,275,27,0.388065278530121,1.11858974358974,1.15562913907285,NA,302,312
"301",26,2.89,1,163,202,0.015299553131864,1.23926380368098,1.23926380368098,0.820927381145132,34,83,38,0.614927411079407,1.39316239316239,1.34710743801653,NA,121,117
"302",26,3.46,2,206,299,0.014160549372484,1.45145631067961,1.45145631067961,0.780385155294396,35,125,37,0.5374995470047,1.2875,1.2716049382716,NA,162,160
"303",26,5.68,3,240,392,0.0136680613668061,1.63333333333333,1.63333333333333,0.73849810637663,31,166,38,0.511691033840179,1.21827411167513,1.17647058823529,NA,204,197
"304",26,6.38,4,257,434,0.013193093385214,1.68871595330739,1.68871595330739,0.76665732604002,40,168,38,0.479589223861694,1.23557692307692,1.24757281553398,NA,206,208
"305",26,9.96,5,292,530,0.0124746975474274,1.81506849315068,1.81506849315068,0.720744159474961,32,212,39,0.454987585544586,1.19672131147541,1.16334661354582,NA,251,244
"306",26,10.74,6,301,564,0.0124916943521595,1.87375415282392,1.87375415282392,0.754247066545496,43,216,38,0.453663378953934,1.16216216216216,1.18503937007874,NA,254,259
"307",26,13.98,7,315,606,0.0122535638459205,1.92380952380952,1.92380952380952,0.652096578818466,32,241,39,0.448138266801834,1.15384615384615,1.125,NA,280,273
"308",26,15.5,8,323,640,0.0123069822894833,1.98142414860681,1.98142414860681,0.710341215538847,41,227,49,0.432181388139725,1.20522388059701,1.17028985507246,NA,276,268
"309",26,18.98,9,333,674,0.0121929158073736,2.02402402402402,2.02402402402402,0.700714398029179,36,256,36,0.421073317527771,1.14041095890411,1.14041095890411,NA,292,292
"310",26,19.11,10,336,698,0.0124022743425728,2.07738095238095,2.07738095238095,0.713504712810392,35,248,44,0.431703150272369,1.18727915194346,1.15068493150685,NA,292,283
"311",26,20.36,11,346,735,0.0123146519225936,2.1242774566474,2.1242774566474,0.674202455762474,38,271,32,0.391326755285263,1.11974110032362,1.14191419141914,NA,303,309
"312",26,21.5,12,349,753,0.0123999604782136,2.15759312320917,2.15759312320917,0.69403383361152,35,270,40,0.42007976770401,1.14426229508197,1.1258064516129,NA,310,305
"313",27,2.89,1,163,202,0.015299553131864,1.23926380368098,1.23926380368098,0.849796532181486,38,85,31,0.616593897342682,1.32520325203252,1.4051724137931,NA,116,123
"314",27,3.46,2,206,299,0.014160549372484,1.45145631067961,1.45145631067961,0.851336734727719,30,117,36,0.509267210960388,1.40136054421769,1.34640522875817,NA,153,147
"315",27,5.68,3,240,392,0.0136680613668061,1.63333333333333,1.63333333333333,0.761501086485712,34,161,37,0.487475961446762,1.23076923076923,1.21212121212121,NA,198,195
"316",27,7.2,4,258,437,0.0131813108919253,1.6937984496124,1.6937984496124,0.799087951346418,47,173,35,0.485196530818939,1.17272727272727,1.24038461538462,NA,208,220
"317",27,7.9,5,274,476,0.0127269324349616,1.73722627737226,1.73722627737226,0.77517562086888,46,190,32,0.473304748535156,1.16101694915254,1.23423423423423,NA,222,236
"318",27,9.04,6,279,503,0.0129702689461334,1.80286738351254,1.80286738351254,0.707389792446633,28,208,38,0.447636216878891,1.18220338983051,1.13414634146341,NA,246,236
"319",27,12.62,7,307,592,0.0126035213216666,1.92833876221498,1.92833876221498,0.773295695517104,39,225,34,0.425454497337341,1.16287878787879,1.18532818532819,NA,259,264
"320",27,13.87,8,319,636,0.0125391849529781,1.99373040752351,1.99373040752351,0.704848035252222,41,236,36,0.411340326070786,1.15162454873646,1.17279411764706,NA,272,277
"321",27,14,9,323,660,0.0126915754860297,2.04334365325077,2.04334365325077,0.700330239879246,45,243,32,0.396375119686127,1.12152777777778,1.17454545454545,NA,275,288
"322",27,17.24,10,333,697,0.0126089945367054,2.09309309309309,2.09309309309309,0.653999536867142,33,262,34,0.400482505559921,1.12881355932203,1.125,NA,296,295
"323",27,18.02,11,340,723,0.0125455491931286,2.12647058823529,2.12647058823529,0.713125613974396,34,263,37,0.440153509378433,1.14478114478114,1.13333333333333,NA,300,297
"324",27,21.5,12,349,753,0.0123999604782136,2.15759312320917,2.15759312320917,0.679654343868995,34,273,39,0.433656275272369,1.13680781758958,1.11858974358974,NA,312,307
"325",28,1.14,1,114,141,0.0218910107126223,1.23684210526316,1.23684210526316,0.807097239446033,16,66,20,0.628615260124207,1.39024390243902,1.32558139534884,NA,86,82
"326",28,3.36,2,187,271,0.0155827726985222,1.44919786096257,1.44919786096257,0.825609774100847,28,113,34,0.514732956886292,1.32624113475177,1.27210884353742,NA,147,141
"327",28,4.88,3,217,327,0.013952892985151,1.50691244239631,1.50691244239631,0.864107500186405,40,127,41,0.519106149673462,1.29940119760479,1.29166666666667,NA,168,167
"328",28,5.66,4,235,376,0.0136752136752137,1.6,1.6,0.784209139425813,35,153,34,0.542482435703278,1.25,1.25668449197861,NA,187,188
"329",28,9.14,5,257,425,0.0129195038910506,1.65369649805447,1.65369649805447,0.69502035020367,32,190,28,0.51578962802887,1.15765765765766,1.17889908256881,NA,218,222
"330",28,9.84,6,275,466,0.0123689449236894,1.69454545454545,1.69454545454545,0.794258606257403,39,177,46,0.464465647935867,1.27314814814815,1.23318385650224,NA,223,216
"331",28,10.41,7,282,501,0.0126448095706822,1.77659574468085,1.77659574468085,0.751527378055349,36,203,39,0.468458324670792,1.17991631799163,1.16528925619835,NA,242,239
"332",28,13.65,8,297,544,0.0123760123760124,1.83164983164983,1.83164983164983,0.680288973507179,34,216,40,0.458396434783936,1.188,1.16015625,NA,256,250
"333",28,14.9,9,312,591,0.0121815483551818,1.89423076923077,1.89423076923077,0.690148393575975,41,228,36,0.437727779150009,1.15985130111524,1.18181818181818,NA,264,269
"334",28,15.03,10,315,616,0.0124557678697806,1.95555555555556,1.95555555555556,0.69820528751901,35,229,45,0.4430171251297,1.19318181818182,1.14963503649635,NA,274,264
"335",28,18.61,11,337,699,0.0123463331920305,2.07418397626113,2.07418397626113,0.691461171360315,39,258,33,0.425345033407211,1.13468013468013,1.15807560137457,NA,291,297
"336",28,21.5,12,349,753,0.0123999604782136,2.15759312320917,2.15759312320917,0.701112993551151,31,280,32,0.409360319375992,1.12218649517685,1.11858974358974,NA,312,311
"337",29,0.7,1,144,151,0.0146658896658897,1.04861111111111,1.04861111111111,1.05995224168605,36,55,31,0.663391888141632,1.58241758241758,1.67441860465116,NA,86,91
"338",29,0.83,2,171,215,0.0147918816649467,1.25730994152047,1.25730994152047,0.965809814596169,38,75,40,0.550784230232239,1.51327433628319,1.48695652173913,NA,115,113
"339",29,4.31,3,203,287,0.0139979515192899,1.41379310344828,1.41379310344828,0.769762243379626,33,124,35,0.57595694065094,1.29299363057325,1.27672955974843,NA,159,157
"340",29,5.45,4,212,332,0.0148439595815076,1.56603773584906,1.56603773584906,0.888028277462546,50,128,29,0.513209462165833,1.19101123595506,1.35031847133758,NA,157,178
"341",29,9.03,5,254,440,0.0136939404313591,1.73228346456693,1.73228346456693,0.783282311535399,39,173,35,0.480286687612534,1.19811320754717,1.22115384615385,NA,208,212
"342",29,11.92,6,282,516,0.0130233966835769,1.82978723404255,1.82978723404255,0.727422426209664,28,207,36,0.470564067363739,1.2,1.16049382716049,NA,243,235
"343",29,13.44,7,294,550,0.0127696129646398,1.87074829931973,1.87074829931973,0.752786716300965,35,211,41,0.428137212991714,1.19512195121951,1.16666666666667,NA,252,246
"344",29,14.22,8,308,584,0.012352468378527,1.8961038961039,1.8961038961039,0.738942059911198,48,210,43,0.460173696279526,1.1937984496124,1.21739130434783,NA,253,258
"345",29,14.79,9,312,617,0.012717454035782,1.9775641025641,1.9775641025641,0.686288973616441,37,234,38,0.428790897130966,1.15129151291513,1.14705882352941,NA,272,271
"346",29,16.04,10,325,655,0.0124406457739791,2.01538461538462,2.01538461538462,0.750336575219558,44,241,36,0.443065106868744,1.14035087719298,1.17328519855596,NA,277,285
"347",29,19.28,11,338,695,0.0122030446157358,2.05621301775148,2.05621301775148,0.679528121973904,40,260,36,0.419903695583344,1.12666666666667,1.14189189189189,NA,296,300
"348",29,21.5,12,349,753,0.0123999604782136,2.15759312320917,2.15759312320917,0.701112993551151,42,274,26,0.43310958147049,1.10443037974684,1.16333333333333,NA,300,316
"349",30,2.89,1,163,202,0.015299553131864,1.23926380368098,1.23926380368098,0.900322263375612,36,79,36,0.574355363845825,1.41739130434783,1.41739130434783,NA,115,115
"350",30,6.37,2,206,286,0.0135448733128108,1.38834951456311,1.38834951456311,0.837164604995558,38,112,41,0.543192803859711,1.37333333333333,1.34640522875817,NA,153,150
"351",30,6.5,3,219,328,0.0137405219722676,1.49771689497717,1.49771689497717,0.797162380304904,38,137,33,0.518134653568268,1.25142857142857,1.28823529411765,NA,170,175
"352",30,7.2,4,240,383,0.0133542538354254,1.59583333333333,1.59583333333333,0.770983879958679,40,151,39,0.518634617328644,1.2565445026178,1.26315789473684,NA,190,191
"353",30,8.34,5,248,420,0.0137129424056419,1.69354838709677,1.69354838709677,0.713563802017198,35,166,40,0.49311226606369,1.23383084577114,1.20388349514563,NA,206,201
"354",30,11.58,6,271,470,0.012846795134618,1.73431734317343,1.73431734317343,0.693755104772898,37,194,33,0.488347679376602,1.17316017316017,1.19383259911894,NA,227,231
"355",30,15.16,7,301,561,0.0124252491694352,1.86378737541528,1.86378737541528,0.718121638457355,41,217,38,0.454575598239899,1.16666666666667,1.18039215686275,NA,255,258
"356",30,17.38,8,317,627,0.0125184682346364,1.97791798107256,1.97791798107256,0.685454239568041,41,229,43,0.454021453857422,1.17407407407407,1.16544117647059,NA,272,270
"357",30,17.95,9,324,658,0.012575010511027,2.03086419753086,2.03086419753086,0.729881933474524,42,231,44,0.408712983131409,1.18681318681319,1.17818181818182,NA,275,273
"358",30,18.73,10,331,686,0.0125606518355763,2.07250755287009,2.07250755287009,0.674182431649907,34,251,39,0.402351498603821,1.16140350877193,1.14137931034483,NA,290,285
"359",30,20.25,11,339,717,0.0125150547206367,2.11504424778761,2.11504424778761,0.742023698591227,45,254,33,0.392019689083099,1.13377926421405,1.18118466898955,NA,287,299
"360",30,21.5,12,349,753,0.0123999604782136,2.15759312320917,2.15759312320917,0.66866682723675,27,288,28,0.421323120594025,1.10793650793651,1.10443037974684,NA,316,315
"361",31,3.48,1,144,158,0.0153457653457653,1.09722222222222,1.09722222222222,0.953865592422684,33,61,33,0.60559207201004,1.53191489361702,1.53191489361702,NA,94,94
"362",31,5,2,182,223,0.0135389472406047,1.22527472527473,1.22527472527473,0.878602515784184,37,95,37,0.590178787708282,1.37878787878788,1.37878787878788,NA,132,132
"363",31,6.25,3,219,309,0.0129445771019228,1.41095890410959,1.41095890410959,0.778478410677371,36,135,39,0.589976012706757,1.28070175438596,1.25862068965517,NA,174,171
"364",31,9.83,4,256,414,0.0126838235294118,1.6171875,1.6171875,0.788358247994552,47,154,48,0.490743637084961,1.27363184079602,1.26732673267327,NA,202,201
"365",31,10.4,5,271,464,0.0126827934946016,1.71217712177122,1.71217712177122,0.728049981985737,42,184,42,0.481348961591721,1.19911504424779,1.19911504424779,NA,226,226
"366",31,12.62,6,300,545,0.0121516164994426,1.81666666666667,1.81666666666667,0.749899463172067,45,204,42,0.460499942302704,1.20481927710843,1.21951219512195,NA,246,249
"367",31,13.76,7,304,571,0.0123979503213479,1.87828947368421,1.87828947368421,0.725397667250093,50,214,36,0.458034485578537,1.15151515151515,1.216,NA,250,264
"368",31,17,8,315,612,0.0123748862602366,1.94285714285714,1.94285714285714,0.757981756508493,28,236,44,0.417077839374542,1.19318181818182,1.125,NA,280,264
"369",31,19.89,9,330,675,0.0124343741365018,2.04545454545455,2.04545454545455,0.722388207356965,41,253,31,0.442062020301819,1.12244897959184,1.16197183098592,NA,284,294
"370",31,20.67,10,339,705,0.0123055977378646,2.07964601769911,2.07964601769911,0.678439642523363,37,269,29,0.42013281583786,1.1078431372549,1.13758389261745,NA,298,306
"371",31,20.8,11,343,727,0.0123949329105076,2.11953352769679,2.11953352769679,0.695924383176501,34,270,32,0.41710764169693,1.12828947368421,1.13576158940397,NA,302,304
"372",31,21.5,12,349,753,0.0123999604782136,2.15759312320917,2.15759312320917,0.65937071624081,28,281,32,0.412646055221558,1.1294498381877,1.11501597444089,NA,313,309
"373",32,1.52,1,120,123,0.0172268907563025,1.025,1.025,0.999602498493664,30,49,30,0.651166617870331,1.51898734177215,1.51898734177215,NA,79,79
"374",32,4.41,2,211,284,0.0128187767998195,1.34597156398104,1.34597156398104,0.857501556408592,36,116,46,0.63025689125061,1.38815789473684,1.30246913580247,NA,162,152
"375",32,7.99,3,251,397,0.0126533864541833,1.58167330677291,1.58167330677291,0.847369809713578,42,159,38,0.498420178890228,1.24875621890547,1.2741116751269,NA,197,201
"376",32,8.69,4,268,444,0.012409860808318,1.65671641791045,1.65671641791045,0.821378424075711,53,165,40,0.498703956604004,1.22935779816514,1.30731707317073,NA,205,218
"377",32,9.26,5,280,492,0.0125960061443932,1.75714285714286,1.75714285714286,0.762992220473911,45,190,35,0.473814785480499,1.19148936170213,1.24444444444444,NA,225,235
"378",32,12.74,6,292,528,0.0124276232170597,1.80821917808219,1.80821917808219,0.74441473312823,44,206,38,0.469609081745148,1.168,1.19672131147541,NA,244,250
"379",32,13.99,7,305,573,0.0123597929249353,1.87868852459016,1.87868852459016,0.740603727196106,40,214,42,0.464436590671539,1.2007874015748,1.19140625,NA,256,254
"380",32,16.21,8,324,644,0.0123074570958988,1.98765432098765,1.98765432098765,0.677623392043892,37,245,35,0.399590313434601,1.14893617021277,1.15714285714286,NA,280,282
"381",32,19.45,9,335,684,0.0122262936812941,2.04179104477612,2.04179104477612,0.676591575851851,30,265,37,0.458513975143433,1.13559322033898,1.10927152317881,NA,302,295
"382",32,19.58,10,339,709,0.012375416732122,2.09144542772861,2.09144542772861,0.69986445316865,38,257,43,0.428610771894455,1.14915254237288,1.13,NA,300,295
"383",32,20.36,11,346,735,0.0123146519225936,2.1242774566474,2.1242774566474,0.646976393145878,28,279,32,0.431511849164963,1.12703583061889,1.11254019292605,NA,311,307
"384",32,21.5,12,349,753,0.0123999604782136,2.15759312320917,2.15759312320917,0.691360460884349,28,284,33,0.423044443130493,1.11858974358974,1.10094637223975,NA,317,312
"385",33,1.14,1,114,141,0.0218910107126223,1.23684210526316,1.23684210526316,0.89543976713171,26,54,27,0.588375866413116,1.425,1.40740740740741,NA,81,80
"386",33,1.71,2,160,226,0.0177672955974843,1.4125,1.4125,0.834234080892868,26,96,25,0.518355011940002,1.31147540983607,1.32231404958678,NA,121,122
"387",33,2.96,3,197,304,0.0157464000828758,1.54314720812183,1.54314720812183,0.839431928153333,42,113,32,0.521809041500092,1.27096774193548,1.35862068965517,NA,145,155
"388",33,3.09,4,212,344,0.0153804882410802,1.62264150943396,1.62264150943396,0.78667668143133,37,126,41,0.487531274557114,1.30061349693252,1.26946107784431,NA,167,163
"389",33,6.67,5,259,454,0.0135883391697345,1.75289575289575,1.75289575289575,0.76190433107337,38,182,32,0.484513640403748,1.17727272727273,1.21028037383178,NA,214,220
"390",33,7.37,6,271,494,0.0135028016946836,1.82287822878229,1.82287822878229,0.696712527478382,26,207,29,0.48580127954483,1.16309012875536,1.14830508474576,NA,236,233
"391",33,10.85,7,282,531,0.0134019837964716,1.88297872340426,1.88297872340426,0.689120990843397,33,210,37,0.462973594665527,1.16049382716049,1.1417004048583,NA,247,243
"392",33,11.63,8,293,562,0.0131375940904203,1.91808873720137,1.91808873720137,0.756024961265936,42,214,31,0.479461401700974,1.14453125,1.19591836734694,NA,245,256
"393",33,14.87,9,310,607,0.0126735567386992,1.95806451612903,1.95806451612903,0.739832883666658,41,218,44,0.47334098815918,1.1969111969112,1.18320610687023,NA,262,259
"394",33,17.76,10,329,664,0.0123063236711394,2.01823708206687,2.01823708206687,0.69851904021617,35,243,45,0.431843340396881,1.18345323741007,1.14236111111111,NA,288,278
"395",33,19.98,11,341,722,0.0124547179575643,2.11730205278592,2.11730205278592,0.638456285714552,30,269,39,0.42712989449501,1.14046822742475,1.10714285714286,NA,308,299
"396",33,21.5,12,349,753,0.0123999604782136,2.15759312320917,2.15759312320917,0.699349921601532,39,274,32,0.419148564338684,1.11501597444089,1.14052287581699,NA,306,313
"397",34,0.78,1,137,147,0.0157793044224989,1.07299270072993,1.07299270072993,0.894452832008268,28,62,31,0.65391731262207,1.52222222222222,1.47311827956989,NA,93,90
"398",34,3,2,199,277,0.0140601999898482,1.39195979899497,1.39195979899497,0.841138175403762,34,107,43,0.534647881984711,1.4113475177305,1.32666666666667,NA,150,141
"399",34,6.24,3,229,345,0.0132153527924615,1.50655021834061,1.50655021834061,0.775526761720428,38,134,49,0.528149545192719,1.33139534883721,1.25136612021858,NA,183,172
"400",34,9.82,4,270,456,0.0125567947129285,1.68888888888889,1.68888888888889,0.769107285855478,40,182,43,0.508579552173615,1.21621621621622,1.2,NA,225,222
"401",34,10.39,5,285,497,0.012280701754386,1.74385964912281,1.74385964912281,0.77766050595325,41,195,45,0.477280080318451,1.20762711864407,1.1875,NA,240,236
"402",34,11.91,6,294,536,0.0124445682709944,1.82312925170068,1.82312925170068,0.718534359138244,42,214,31,0.469386994838715,1.1484375,1.2,NA,245,256
"403",34,14.8,7,312,609,0.0125525599802127,1.95192307692308,1.95192307692308,0.682710073975136,32,226,51,0.413570642471313,1.2093023255814,1.12635379061372,NA,277,258
"404",34,16.05,8,325,655,0.0124406457739791,2.01538461538462,2.01538461538462,0.695685654681543,38,243,38,0.439931243658066,1.15658362989324,1.15658362989324,NA,281,281
"405",34,17.19,9,329,674,0.012491659871006,2.04863221884498,2.04863221884498,0.709635301665171,35,252,38,0.441703915596008,1.14634146341463,1.13448275862069,NA,290,287
"406",34,20.67,10,339,705,0.0123055977378646,2.07964601769911,2.07964601769911,0.686458714908045,39,264,33,0.414741724729538,1.11881188118812,1.14141414141414,NA,297,303
"407",34,21.37,11,346,731,0.0122476334087292,2.11271676300578,2.11271676300578,0.672577246128916,28,269,42,0.394639551639557,1.16498316498317,1.11254019292605,NA,311,297
"408",34,21.5,12,349,753,0.0123999604782136,2.15759312320917,2.15759312320917,0.682373579839721,34,270,41,0.409498780965805,1.14802631578947,1.12218649517685,NA,311,304
"409",35,0.7,1,144,151,0.0146658896658897,1.04861111111111,1.04861111111111,0.93226159345839,32,65,31,0.648546159267426,1.48453608247423,1.5,NA,96,97
"410",35,1.27,2,184,236,0.0140175813732478,1.28260869565217,1.28260869565217,0.849599959550546,36,95,42,0.559205293655396,1.40458015267176,1.34306569343066,NA,137,131
"411",35,2.05,3,210,294,0.0133971291866029,1.4,1.4,0.836152183269627,36,114,44,0.526441514492035,1.4,1.32911392405063,NA,158,150
"412",35,3.57,4,233,342,0.012653544472399,1.46781115879828,1.46781115879828,0.858054348930911,45,133,41,0.529731392860413,1.30898876404494,1.33908045977011,NA,174,178
"413",35,4.82,5,255,409,0.0126293036899799,1.60392156862745,1.60392156862745,0.872120499952812,44,161,38,0.487114518880844,1.24390243902439,1.28140703517588,NA,199,205
"414",35,8.3,6,272,450,0.0122096809203386,1.65441176470588,1.65441176470588,0.781929200773087,41,184,37,0.505558013916016,1.20888888888889,1.23076923076923,NA,221,225
"415",35,10.52,7,296,525,0.0120247366010078,1.77364864864865,1.77364864864865,0.779466055428583,46,207,34,0.463878452777863,1.1699604743083,1.22821576763485,NA,241,253
"416",35,13.76,8,309,568,0.011936283780944,1.83818770226537,1.83818770226537,0.746474289548344,36,220,45,0.45207267999649,1.20703125,1.16603773584906,NA,265,256
"417",35,13.89,9,312,595,0.0122639953829664,1.90705128205128,1.90705128205128,0.697523687856087,35,236,34,0.49423485994339,1.15129151291513,1.15555555555556,NA,270,271
"418",35,17.47,10,334,679,0.0122098146050242,2.03293413173653,2.03293413173653,0.725629692490111,41,248,38,0.425173670053482,1.15570934256055,1.16783216783217,NA,286,289
"419",35,18.61,11,337,699,0.0123463331920305,2.07418397626113,2.07418397626113,0.674238926910553,33,264,35,0.442056030035019,1.13468013468013,1.12709030100334,NA,299,297
"420",35,21.5,12,349,753,0.0123999604782136,2.15759312320917,2.15759312320917,0.637475409165522,34,279,34,0.383455991744995,1.11501597444089,1.11501597444089,NA,313,313
"421",36,3.48,1,144,158,0.0153457653457653,1.09722222222222,1.09722222222222,0.916600151861923,37,65,31,0.672187983989716,1.41176470588235,1.5,NA,96,102
"422",36,4.73,2,189,252,0.0141843971631206,1.33333333333333,1.33333333333333,0.761874089111563,22,111,39,0.592994153499603,1.42105263157895,1.26,NA,150,133
"423",36,4.86,3,205,298,0.0142515542802487,1.45365853658537,1.45365853658537,0.756665050201549,33,120,42,0.52250462770462,1.33986928104575,1.26543209876543,NA,162,153
"424",36,6.38,4,233,352,0.0130235311528785,1.51072961373391,1.51072961373391,0.789719824052422,38,143,46,0.570913791656494,1.28729281767956,1.23280423280423,NA,189,181
"425",36,7.16,5,252,395,0.0124897236451021,1.56746031746032,1.56746031746032,0.774428379807263,36,169,32,0.50564968585968,1.22926829268293,1.25373134328358,NA,201,205
"426",36,7.86,6,269,439,0.012178882538978,1.63197026022305,1.63197026022305,0.778477525405411,42,179,39,0.47654116153717,1.21719457013575,1.23394495412844,NA,218,221
"427",36,11.44,7,295,532,0.0122679580306699,1.80338983050847,1.80338983050847,0.722123335066209,32,210,41,0.480068862438202,1.21900826446281,1.17529880478088,NA,251,242
"428",36,14.68,8,314,584,0.0118841700413097,1.85987261146497,1.85987261146497,0.710027355838663,35,227,43,0.474930793046951,1.19847328244275,1.16296296296296,NA,270,262
"429",36,16.9,9,330,651,0.0119922630560928,1.97272727272727,1.97272727272727,0.698537482388131,42,240,43,0.436619967222214,1.17021276595745,1.1660777385159,NA,283,282
"430",36,19.79,10,343,708,0.0120709938110583,2.06413994169096,2.06413994169096,0.674325983310202,33,256,46,0.410498261451721,1.18685121107266,1.13576158940397,NA,302,289
"431",36,20.36,11,346,735,0.0123146519225936,2.1242774566474,2.1242774566474,0.674202455762474,37,267,36,0.422056555747986,1.13815789473684,1.14191419141914,NA,303,304
"432",36,21.5,12,349,753,0.0123999604782136,2.15759312320917,2.15759312320917,0.64994165663156,31,279,35,0.414723575115204,1.1258064516129,1.11146496815287,NA,314,310
"433",37,0.57,1,142,160,0.0159824193387274,1.12676056338028,1.12676056338028,1.06677747651381,36,58,30,0.584570288658142,1.51063829787234,1.61363636363636,NA,88,94
"434",37,3.81,2,193,247,0.0133311744386874,1.27979274611399,1.27979274611399,0.928126522199005,38,107,33,0.584938287734985,1.33103448275862,1.37857142857143,NA,140,145
"435",37,4.59,3,220,307,0.0127438771274388,1.39545454545455,1.39545454545455,0.825480191685099,37,124,42,0.54888641834259,1.36645962732919,1.32530120481928,NA,166,161
"436",37,4.72,4,229,347,0.0132919635332874,1.51528384279476,1.51528384279476,0.778399918572845,36,133,52,0.566286623477936,1.35502958579882,1.23783783783784,NA,185,169
"437",37,6.24,5,247,390,0.0128369704749679,1.57894736842105,1.57894736842105,0.764247390623006,30,169,33,0.494036823511124,1.24120603015075,1.22277227722772,NA,202,199
"438",37,8.46,6,269,470,0.0130388947456028,1.74721189591078,1.74721189591078,0.703417000874095,37,189,36,0.498012661933899,1.19026548672566,1.19555555555556,NA,225,226
"439",37,9.6,7,273,497,0.0133861236802413,1.82051282051282,1.82051282051282,0.779818175477253,38,186,40,0.434502422809601,1.21875,1.20796460176991,NA,226,224
"440",37,13.08,8,288,536,0.0129694154084398,1.86111111111111,1.86111111111111,0.713760738757843,26,211,45,0.465720057487488,1.21518987341772,1.125,NA,256,237
"441",37,14.33,9,305,585,0.012618636755824,1.91803278688525,1.91803278688525,0.731817453942011,36,228,35,0.444502890110016,1.15530303030303,1.15969581749049,NA,263,264
"442",37,17.91,10,329,669,0.0123989917710727,2.03343465045593,2.03343465045593,0.73095674550447,41,244,41,0.422096639871597,1.15438596491228,1.15438596491228,NA,285,285
"443",37,20.8,11,343,727,0.0123949329105076,2.11953352769679,2.11953352769679,0.721636603860091,42,256,41,0.438700586557388,1.1510067114094,1.15488215488215,NA,297,298
"444",37,21.5,12,349,753,0.0123999604782136,2.15759312320917,2.15759312320917,0.700232012468126,35,275,33,0.403904557228088,1.1258064516129,1.13311688311688,NA,308,310
"445",38,0.13,1,110,118,0.0196830692243536,1.07272727272727,1.07272727272727,0.950908587252058,22,48,25,0.603346765041351,1.57142857142857,1.50684931506849,NA,73,70
"446",38,0.7,2,168,219,0.0156116338751069,1.30357142857143,1.30357142857143,0.883509659619948,29,85,36,0.528689980506897,1.47368421052632,1.38842975206612,NA,121,114
"447",38,3.94,3,206,295,0.0139711105848923,1.43203883495146,1.43203883495146,0.834194350162954,38,127,31,0.568428635597229,1.24848484848485,1.30379746835443,NA,158,165
"448",38,5.08,4,214,338,0.0148304155148962,1.57943925233645,1.57943925233645,0.776217996339823,29,145,30,0.496875077486038,1.22988505747126,1.22285714285714,NA,175,174
"449",38,8.56,5,235,387,0.0140752864157119,1.6468085106383,1.6468085106383,0.803478123354182,45,149,30,0.48234611749649,1.21134020618557,1.31284916201117,NA,179,194
"450",38,9.26,6,253,432,0.0135516657255788,1.70750988142292,1.70750988142292,0.789837659383617,44,176,27,0.498341590166092,1.15,1.24630541871921,NA,203,220
"451",38,10.51,7,269,486,0.0134827720135383,1.80669144981413,1.80669144981413,0.710778329266014,38,187,39,0.481259256601334,1.19555555555556,1.19026548672566,NA,226,225
"452",38,14.09,8,301,577,0.0127796234772979,1.91694352159468,1.91694352159468,0.733380602785936,46,209,42,0.423938751220703,1.18039215686275,1.199203187251,NA,251,255
"453",38,15.61,9,312,609,0.0125525599802127,1.95192307692308,1.95192307692308,0.698595461339771,32,231,43,0.426291733980179,1.18631178707224,1.13868613138686,NA,274,263
"454",38,17.83,10,329,670,0.0124175253910594,2.03647416413374,2.03647416413374,0.672698073254143,30,254,39,0.435138136148453,1.15845070422535,1.12286689419795,NA,293,284
"455",38,18.61,11,337,699,0.0123463331920305,2.07418397626113,2.07418397626113,0.686440660680158,36,261,37,0.402433663606644,1.13468013468013,1.13087248322148,NA,298,297
"456",38,21.5,12,349,753,0.0123999604782136,2.15759312320917,2.15759312320917,0.66866682723675,28,276,42,0.424493253231049,1.14802631578947,1.09748427672956,NA,318,304
"457",39,3.48,1,144,158,0.0153457653457653,1.09722222222222,1.09722222222222,0.971962670793054,31,64,32,0.588487446308136,1.51578947368421,1.5,NA,96,95
"458",39,6.72,2,198,252,0.012921089063221,1.27272727272727,1.27272727272727,0.794189246076037,39,110,44,0.620701014995575,1.32885906040268,1.28571428571429,NA,154,149
"459",39,7.5,3,230,313,0.011885323713689,1.36086956521739,1.36086956521739,0.91239422579329,43,135,36,0.579147458076477,1.29213483146067,1.34502923976608,NA,171,178
"460",39,7.63,4,238,351,0.0124454845229231,1.47478991596639,1.47478991596639,0.811369704663325,45,139,44,0.505085229873657,1.29347826086957,1.30054644808743,NA,183,184
"461",39,8.33,5,257,399,0.0121291342412451,1.55252918287938,1.55252918287938,0.765453716429037,40,157,46,0.54397588968277,1.30456852791878,1.26600985221675,NA,203,197
"462",39,8.9,6,266,440,0.0124840402894028,1.65413533834586,1.65413533834586,0.777378494804975,40,163,55,0.491856962442398,1.31034482758621,1.22018348623853,NA,218,203
"463",39,11.12,7,286,513,0.0125874125874126,1.79370629370629,1.79370629370629,0.743458661545947,38,208,34,0.481464385986328,1.16260162601626,1.18181818181818,NA,242,246
"464",39,14.01,8,303,583,0.0127423338360326,1.92409240924092,1.92409240924092,0.719788941399549,39,228,31,0.453318536281586,1.13483146067416,1.16988416988417,NA,259,267
"465",39,15.15,9,306,603,0.0129218900675024,1.97058823529412,1.97058823529412,0.68437966000481,33,230,38,0.432705223560333,1.16349809885932,1.14179104477612,NA,268,263
"466",39,16.4,10,317,641,0.0127979874615661,2.02208201892744,2.02208201892744,0.712999592026313,32,238,36,0.416624277830124,1.17407407407407,1.15693430656934,NA,274,270
"467",39,19.98,11,341,722,0.0124547179575643,2.11730205278592,2.11730205278592,0.664637105852906,28,267,40,0.405685812234879,1.15593220338983,1.11074918566775,NA,307,295
"468",39,21.5,12,349,753,0.0123999604782136,2.15759312320917,2.15759312320917,0.681468373457039,31,274,37,0.415927290916443,1.14426229508197,1.12218649517685,NA,311,305
"469",40,3.58,1,171,218,0.0149982800137599,1.27485380116959,1.27485380116959,0.867825242978968,30,89,35,0.566850423812866,1.43697478991597,1.37903225806452,NA,124,119
"470",40,4.36,2,213,299,0.0132429798919302,1.4037558685446,1.4037558685446,0.846402918377978,37,128,35,0.574104309082031,1.29090909090909,1.30674846625767,NA,163,165
"471",40,5.5,3,230,354,0.0134421872033416,1.53913043478261,1.53913043478261,0.806835691155293,41,149,32,0.507736444473267,1.21052631578947,1.2707182320442,NA,181,190
"472",40,6.2,4,249,401,0.0129874336053893,1.61044176706827,1.61044176706827,0.813078214934954,48,149,42,0.515712022781372,1.26395939086294,1.30366492146597,NA,191,197
"473",40,8.42,5,277,483,0.0126353790613718,1.74368231046931,1.74368231046931,0.834799759843689,52,174,40,0.462422132492065,1.22566371681416,1.29439252336449,NA,214,226
"474",40,9.94,6,292,526,0.0123805488866921,1.8013698630137,1.8013698630137,0.723643619936422,43,210,33,0.446412026882172,1.15415019762846,1.20164609053498,NA,243,253
"475",40,10.51,7,300,559,0.012463768115942,1.86333333333333,1.86333333333333,0.686600880720518,36,214,45,0.480845272541046,1.2,1.15830115830116,NA,259,250
"476",40,13.99,8,309,594,0.0124826629680999,1.92233009708738,1.92233009708738,0.74288825396199,35,226,39,0.478543847799301,1.18390804597701,1.16603773584906,NA,265,261
"477",40,16.88,9,325,656,0.0124596391263058,2.01846153846154,2.01846153846154,0.691874769271108,39,232,48,0.423161178827286,1.19926199261993,1.16071428571429,NA,280,271
"478",40,18.13,10,337,694,0.0122580189345768,2.0593471810089,2.0593471810089,0.682018757367557,33,257,38,0.41410419344902,1.16206896551724,1.14237288135593,NA,295,290
"479",40,18.26,11,340,716,0.012424084678119,2.10588235294118,2.10588235294118,0.678544215310285,30,275,33,0.413585364818573,1.11475409836066,1.1038961038961,NA,308,305
"480",40,21.5,12,349,753,0.0123999604782136,2.15759312320917,2.15759312320917,0.671430563178461,34,275,39,0.421334624290466,1.1294498381877,1.11146496815287,NA,314,309
"481",41,0.57,1,142,160,0.0159824193387274,1.12676056338028,1.12676056338028,0.883457103599665,29,67,30,0.608808636665344,1.47916666666667,1.4639175257732,NA,97,96
"482",41,1.27,2,184,236,0.0140175813732478,1.28260869565217,1.28260869565217,0.917279309086476,48,88,41,0.610420823097229,1.35294117647059,1.42635658914729,NA,129,136
"483",41,4.85,3,239,358,0.0125874617629479,1.4979079497908,1.4979079497908,0.856505820333131,50,135,40,0.491830766201019,1.29189189189189,1.36571428571429,NA,175,185
"484",41,4.98,4,249,402,0.0130198212203653,1.6144578313253,1.6144578313253,0.783675224306685,36,158,40,0.508062899112701,1.28350515463918,1.25757575757576,NA,198,194
"485",41,5.76,5,262,442,0.0129273785499108,1.68702290076336,1.68702290076336,0.754028492146875,36,184,37,0.46673384308815,1.19090909090909,1.18552036199095,NA,221,220
"486",41,8.65,6,286,520,0.0127591706539075,1.81818181818182,1.81818181818182,0.733245608788091,43,195,41,0.471390545368195,1.20168067226891,1.21186440677966,NA,236,238
"487",41,12.13,7,297,557,0.0126717626717627,1.87542087542088,1.87542087542088,0.766954582593265,41,209,40,0.478586614131927,1.188,1.19277108433735,NA,249,250
"488",41,15.37,8,315,603,0.0121929026387625,1.91428571428571,1.91428571428571,0.718906103120862,44,228,35,0.466275572776794,1.15808823529412,1.19771863117871,NA,263,272
"489",41,16.62,9,326,643,0.0121378008494573,1.97239263803681,1.97239263803681,0.70294057474181,43,252,28,0.452852666378021,1.10508474576271,1.16428571428571,NA,280,295
"490",41,17.76,10,329,664,0.0123063236711394,2.01823708206687,2.01823708206687,0.695297025068077,41,246,39,0.428480893373489,1.14634146341463,1.15438596491228,NA,285,287
"491",41,19.28,11,338,695,0.0122030446157358,2.05621301775148,2.05621301775148,0.659612619694587,31,258,40,0.41236686706543,1.16955017301038,1.13422818791946,NA,298,289
"492",41,21.5,12,349,753,0.0123999604782136,2.15759312320917,2.15759312320917,0.701112993551151,42,275,28,0.415260642766953,1.10094637223975,1.15181518151815,NA,303,317
"493",42,3.48,1,144,158,0.0153457653457653,1.09722222222222,1.09722222222222,0.959935860744686,36,62,36,0.668662786483765,1.46938775510204,1.46938775510204,NA,98,98
"494",42,4.73,2,189,252,0.0141843971631206,1.33333333333333,1.33333333333333,0.925050314905294,47,97,33,0.555901944637299,1.3125,1.45384615384615,NA,130,144
"495",42,8.31,3,239,373,0.0131148693787138,1.56066945606695,1.56066945606695,0.814812693091745,36,147,39,0.488636434078217,1.30601092896175,1.28494623655914,NA,186,183
"496",42,11.55,4,269,438,0.012151140209732,1.62825278810409,1.62825278810409,0.732105478597006,39,180,45,0.522810161113739,1.22831050228311,1.19555555555556,NA,225,219
"497",42,14.44,5,295,511,0.0117836965294592,1.73220338983051,1.73220338983051,0.748208041021715,40,207,38,0.48898783326149,1.19433198380567,1.20408163265306,NA,245,247
"498",42,15.96,6,307,547,0.0116454833833642,1.78175895765472,1.78175895765472,0.747207648223308,43,206,44,0.455896973609924,1.23293172690763,1.228,NA,250,249
"499",42,16.53,7,314,586,0.0119248692537799,1.86624203821656,1.86624203821656,0.694881015227794,39,220,44,0.434051305055618,1.21235521235521,1.18939393939394,NA,264,259
"500",42,17.67,8,318,610,0.0121024542189949,1.91823899371069,1.91823899371069,0.679059791890145,34,240,38,0.458114773035049,1.16058394160584,1.14388489208633,NA,278,274
"501",42,18.45,9,328,642,0.0119713582456925,1.95731707317073,1.95731707317073,0.703155527158746,42,240,37,0.484560757875443,1.16312056737589,1.1841155234657,NA,277,282
"502",42,20.67,10,339,705,0.0123055977378646,2.07964601769911,2.07964601769911,0.713816385924363,39,257,42,0.424501806497574,1.14527027027027,1.13377926421405,NA,299,296
"503",42,21.37,11,346,731,0.0122476334087292,2.11271676300578,2.11271676300578,0.692556190375441,34,270,37,0.405568540096283,1.13815789473684,1.12703583061889,NA,307,304
"504",42,21.5,12,349,753,0.0123999604782136,2.15759312320917,2.15759312320917,0.661240393743537,36,271,38,0.414756178855896,1.13680781758958,1.1294498381877,NA,309,307
"505",43,0.78,1,137,147,0.0157793044224989,1.07299270072993,1.07299270072993,0.901564753721596,26,58,35,0.626961052417755,1.63095238095238,1.47311827956989,NA,93,84
"506",43,2.3,2,181,217,0.0133210558624923,1.19889502762431,1.19889502762431,0.858849448187664,42,86,46,0.638355016708374,1.4140625,1.37121212121212,NA,132,128
"507",43,3.44,3,199,280,0.0142124765240343,1.4070351758794,1.4070351758794,0.848223342398676,35,118,32,0.554642796516418,1.30065359477124,1.32666666666667,NA,150,153
"508",43,4.14,4,230,335,0.0127207138788684,1.45652173913043,1.45652173913043,0.820507335352451,35,140,38,0.508879482746124,1.31428571428571,1.29213483146067,NA,178,175
"509",43,4.27,5,240,371,0.0129358437935844,1.54583333333333,1.54583333333333,0.799980860781777,43,143,50,0.504083037376404,1.29032258064516,1.24352331606218,NA,193,186
"510",43,7.16,6,272,456,0.0123724766659431,1.67647058823529,1.67647058823529,0.743932200431412,37,177,48,0.516795992851257,1.27102803738318,1.20888888888889,NA,225,214
"511",43,9.38,7,290,530,0.0126476554110488,1.82758620689655,1.82758620689655,0.726430144094314,41,209,37,0.469811320304871,1.16,1.17886178861789,NA,246,250
"512",43,12.62,8,303,571,0.0124800559526151,1.88448844884488,1.88448844884488,0.712827104050525,33,215,47,0.427229970693588,1.22177419354839,1.15648854961832,NA,262,248
"513",43,16.1,9,314,605,0.0123115117722472,1.92675159235669,1.92675159235669,0.704869361077501,39,240,34,0.482053160667419,1.12544802867384,1.14598540145985,NA,274,279
"514",43,16.67,10,318,637,0.0126381366188521,2.00314465408805,2.00314465408805,0.664107324224186,39,241,34,0.43484964966774,1.13571428571429,1.15636363636364,NA,275,280
"515",43,20.25,11,339,717,0.0125150547206367,2.11504424778761,2.11504424778761,0.7035937058346,37,255,39,0.438451319932938,1.16095890410959,1.1530612244898,NA,294,292
"516",43,21.5,12,349,753,0.0123999604782136,2.15759312320917,2.15759312320917,0.718505809682944,39,272,35,0.413030505180359,1.12218649517685,1.13680781758958,NA,307,311
"517",44,3.48,1,144,158,0.0153457653457653,1.09722222222222,1.09722222222222,0.922915557745704,28,70,31,0.657186388969421,1.46938775510204,1.42574257425743,NA,101,98
"518",44,4.18,2,190,240,0.0133667502088555,1.26315789473684,1.26315789473684,0.937141073756924,37,97,40,0.559435784816742,1.41791044776119,1.38686131386861,NA,137,134
"519",44,4.96,3,219,297,0.0124418750785472,1.35616438356164,1.35616438356164,0.802515937375791,37,128,39,0.568122327327728,1.32727272727273,1.31137724550898,NA,167,165
"520",44,6.21,4,240,360,0.0125523012552301,1.5,1.5,0.768994706831774,46,148,35,0.546084105968475,1.23711340206186,1.31147540983607,NA,183,194
"521",44,9.45,5,268,421,0.0117670076583375,1.57089552238806,1.57089552238806,0.811275269977052,46,170,39,0.51527863740921,1.24074074074074,1.2822966507177,NA,209,216
"522",44,10.59,6,274,455,0.0121654501216545,1.66058394160584,1.66058394160584,0.787985333914087,45,169,46,0.51010262966156,1.2803738317757,1.27441860465116,NA,215,214
"523",44,13.48,7,297,520,0.0118300118300118,1.75084175084175,1.75084175084175,0.705449749105288,33,219,39,0.463563233613968,1.17857142857143,1.15116279069767,NA,258,252
"524",44,15,8,312,554,0.0114189133481738,1.77564102564103,1.77564102564103,0.799197400463023,39,213,50,0.433579504489899,1.23809523809524,1.18631178707224,NA,263,252
"525",44,15.13,9,315,581,0.0117480537862703,1.84444444444444,1.84444444444444,0.703967242360125,36,228,42,0.461275190114975,1.19318181818182,1.16666666666667,NA,270,264
"526",44,15.7,10,318,615,0.0122016546634129,1.93396226415094,1.93396226415094,0.78981377161477,47,230,26,0.445306330919266,1.14801444043321,1.2421875,NA,256,277
"527",44,19.28,11,338,695,0.0122030446157358,2.05621301775148,2.05621301775148,0.6733026589157,33,268,32,0.416323214769363,1.12292358803987,1.12666666666667,NA,300,301
"528",44,21.5,12,349,753,0.0123999604782136,2.15759312320917,2.15759312320917,0.688676710475196,37,272,34,0.377345025539398,1.1294498381877,1.14052287581699,NA,306,309
"529",45,3.24,1,156,170,0.0140612076095947,1.08974358974359,1.08974358974359,0.985428380214741,37,72,30,0.627145349979401,1.43119266055046,1.52941176470588,NA,102,109
"530",45,4.76,2,196,235,0.0122972265829409,1.19897959183673,1.19897959183673,0.939139466179709,44,100,35,0.644019961357117,1.36111111111111,1.45185185185185,NA,135,144
"531",45,5.46,3,233,300,0.0110996004143851,1.28755364806867,1.28755364806867,0.911769415714823,46,123,39,0.554161131381989,1.37869822485207,1.43827160493827,NA,162,169
"532",45,6.03,4,247,354,0.0116520193542016,1.4331983805668,1.4331983805668,0.847166249113691,41,145,42,0.521976470947266,1.32795698924731,1.32085561497326,NA,187,186
"533",45,6.16,5,254,395,0.0122934237963338,1.55511811023622,1.55511811023622,0.7950223968854,41,159,42,0.531107187271118,1.27,1.2636815920398,NA,201,200
"534",45,8.38,6,273,473,0.012739711269123,1.73260073260073,1.73260073260073,0.758272899138839,37,183,41,0.479895293712616,1.24090909090909,1.21875,NA,224,220
"535",45,11.96,7,303,567,0.012392629991476,1.87128712871287,1.87128712871287,0.703904165866004,34,228,33,0.46418234705925,1.15648854961832,1.16091954022988,NA,261,262
"536",45,14.85,8,319,635,0.0125194692533665,1.99059561128527,1.99059561128527,0.669602055578128,34,241,35,0.448308050632477,1.16,1.15579710144928,NA,276,275
"537",45,18.33,9,329,670,0.0124175253910594,2.03647416413374,2.03647416413374,0.661679647227655,36,253,34,0.432564049959183,1.13840830449827,1.14634146341463,NA,287,289
"538",45,19.58,10,339,709,0.012375416732122,2.09144542772861,2.09144542772861,0.626427690987073,29,267,41,0.424302875995636,1.14527027027027,1.10064935064935,NA,308,296
"539",45,20.36,11,346,735,0.0123146519225936,2.1242774566474,2.1242774566474,0.724710484846926,40,258,41,0.441413253545761,1.16107382550336,1.15719063545151,NA,299,298
"540",45,21.5,12,349,753,0.0123999604782136,2.15759312320917,2.15759312320917,0.680561963072495,35,273,39,0.421889185905457,1.13311688311688,1.11858974358974,NA,312,308
"541",46,0.78,1,137,147,0.0157793044224989,1.07299270072993,1.07299270072993,0.929468423893445,35,59,32,0.688254833221436,1.45744680851064,1.50549450549451,NA,91,94
"542",46,1.35,2,185,236,0.0138660399529965,1.27567567567568,1.27567567567568,0.870576332821181,36,94,40,0.617225646972656,1.42307692307692,1.38059701492537,NA,134,130
"543",46,4.24,3,227,349,0.0136057073798292,1.5374449339207,1.5374449339207,0.805295059091606,46,143,31,0.528304398059845,1.2010582010582,1.30459770114943,NA,174,189
"544",46,5.38,4,233,382,0.014133491194317,1.63948497854077,1.63948497854077,0.7531411400551,34,147,44,0.47167706489563,1.28729281767956,1.21989528795812,NA,191,181
"545",46,6.08,5,249,423,0.013699961134862,1.69879518072289,1.69879518072289,0.729052654259586,34,162,42,0.502746880054474,1.27040816326531,1.22058823529412,NA,204,196
"546",46,9.66,6,285,521,0.0128737336298493,1.8280701754386,1.8280701754386,0.763033763032313,34,204,39,0.477409482002258,1.19747899159664,1.17283950617284,NA,243,238
"547",46,12.9,7,304,564,0.0122459614382491,1.85526315789474,1.85526315789474,0.7166485923425,36,221,40,0.463493704795837,1.18287937743191,1.16475095785441,NA,261,257
"548",46,15.12,8,319,627,0.0123617436564736,1.96551724137931,1.96551724137931,0.718731527123883,32,238,41,0.446068614721298,1.18148148148148,1.14336917562724,NA,279,270
"549",46,16.64,9,327,661,0.012401268268888,2.02140672782875,2.02140672782875,0.700074482796065,36,245,38,0.437240332365036,1.16370106761566,1.15547703180212,NA,283,281
"550",46,20.12,10,336,693,0.0123134328358209,2.0625,2.0625,0.7396800834307,43,254,33,0.42058390378952,1.13131313131313,1.17073170731707,NA,287,297
"551",46,20.25,11,339,717,0.0125150547206367,2.11504424778761,2.11504424778761,0.657932624309241,26,273,37,0.444425970315933,1.13377926421405,1.09354838709677,NA,310,299
"552",46,21.5,12,349,753,0.0123999604782136,2.15759312320917,2.15759312320917,0.679654343868995,44,268,35,0.413847029209137,1.11858974358974,1.15181518151815,NA,303,312
"553",47,1.14,1,114,141,0.0218910107126223,1.23684210526316,1.23684210526316,0.785300438982522,24,59,25,0.61352550983429,1.37349397590361,1.35714285714286,NA,84,83
"554",47,4.72,2,198,293,0.0150233297441419,1.47979797979798,1.47979797979798,0.835891496953271,34,111,37,0.53938889503479,1.36551724137931,1.33783783783784,NA,148,145
"555",47,5.29,3,223,354,0.0143012968125076,1.58744394618834,1.58744394618834,0.811102018607143,38,142,37,0.508023679256439,1.23888888888889,1.24581005586592,NA,179,180
"556",47,5.42,4,237,395,0.0141242937853107,1.66666666666667,1.66666666666667,0.677232654112758,24,172,30,0.515378952026367,1.20918367346939,1.17326732673267,NA,202,196
"557",47,6.2,5,256,436,0.0133578431372549,1.703125,1.703125,0.719996985349007,36,173,40,0.469065636396408,1.22488038277512,1.2018779342723,NA,213,209
"558",47,6.9,6,268,478,0.0133601654648108,1.78358208955224,1.78358208955224,0.774463751825931,40,184,38,0.502223372459412,1.19642857142857,1.20720720720721,NA,222,224
"559",47,9.79,7,291,549,0.0130110202630643,1.88659793814433,1.88659793814433,0.691287328836821,37,207,43,0.433958381414413,1.19262295081967,1.164,NA,250,244
"560",47,11.04,8,304,589,0.0127887788778878,1.9375,1.9375,0.721321773017469,39,220,41,0.440193831920624,1.17374517374517,1.16475095785441,NA,261,259
"561",47,13.26,9,322,650,0.012577156014783,2.01863354037267,2.01863354037267,0.676082959054453,34,233,51,0.419763296842575,1.2059925093633,1.13380281690141,NA,284,267
"562",47,16.74,10,331,682,0.0124874118831823,2.06042296072508,2.06042296072508,0.68989292303468,31,264,30,0.42384934425354,1.12203389830508,1.12585034013605,NA,294,295
"563",47,19.98,11,341,722,0.0124547179575643,2.11730205278592,2.11730205278592,0.714125051999116,42,260,36,0.386140793561935,1.12913907284768,1.15202702702703,NA,296,302
"564",47,21.5,12,349,753,0.0123999604782136,2.15759312320917,2.15759312320917,0.676011681389913,41,269,35,0.422457993030548,1.1258064516129,1.14802631578947,NA,304,310
"565",48,0.78,1,137,147,0.0157793044224989,1.07299270072993,1.07299270072993,0.949858389662046,28,64,33,0.603290319442749,1.48913043478261,1.41237113402062,NA,97,92
"566",48,4.02,2,197,246,0.0127421526986429,1.24873096446701,1.24873096446701,0.883957372687291,43,101,41,0.637137293815613,1.36805555555556,1.38732394366197,NA,142,144
"567",48,6.91,3,243,354,0.0120395877971636,1.45679012345679,1.45679012345679,0.80194979463565,40,149,42,0.540908634662628,1.28571428571429,1.27225130890052,NA,191,189
"568",48,8.05,4,251,391,0.0124621513944223,1.55776892430279,1.55776892430279,0.866897276240423,49,157,30,0.497566729784012,1.21844660194175,1.34224598930481,NA,187,206
"569",48,9.3,5,271,443,0.0121087877545442,1.63468634686347,1.63468634686347,0.839791978394788,37,185,35,0.465133637189865,1.22072072072072,1.23181818181818,NA,220,222
"570",48,9.43,6,277,473,0.0123737770104118,1.70758122743682,1.70758122743682,0.768518677482987,42,190,39,0.476326256990433,1.19396551724138,1.20960698689956,NA,229,232
"571",48,10.95,7,296,515,0.0117956939990838,1.73986486486486,1.73986486486486,0.771095733600045,45,188,53,0.485338807106018,1.27038626609442,1.22821576763485,NA,241,233
"572",48,14.53,8,319,606,0.01194771396463,1.89968652037618,1.89968652037618,0.713845877872712,35,233,44,0.440320461988449,1.19029850746269,1.15162454873646,NA,277,268
"573",48,16.75,9,331,670,0.0122676920260002,2.02416918429003,2.02416918429003,0.68141105594002,36,257,32,0.412586271762848,1.12969283276451,1.14532871972318,NA,289,293
"574",48,17.32,10,334,697,0.0125334915754077,2.08682634730539,2.08682634730539,0.666648613503756,35,256,39,0.431657284498215,1.14776632302405,1.13220338983051,NA,295,291
"575",48,18.02,11,340,723,0.0125455491931286,2.12647058823529,2.12647058823529,0.619109593754108,31,272,34,0.401357114315033,1.12211221122112,1.11111111111111,NA,306,303
"576",48,21.5,12,349,753,0.0123999604782136,2.15759312320917,2.15759312320917,0.63553582149912,32,279,37,0.401887804269791,1.12218649517685,1.10443037974684,NA,316,311
"577",49,2.22,1,171,214,0.0147230822153423,1.25146198830409,1.25146198830409,0.804189180215286,29,93,36,0.599255323410034,1.40163934426229,1.32558139534884,NA,129,122
"578",49,3.36,2,187,271,0.0155827726985222,1.44919786096257,1.44919786096257,0.856055210347432,40,107,32,0.542571604251862,1.27210884353742,1.34532374100719,NA,139,147
"579",49,6.25,3,232,378,0.0141065830721003,1.62931034482759,1.62931034482759,0.80168694632651,36,142,46,0.464548170566559,1.30337078651685,1.23404255319149,NA,188,178
"580",49,9.49,4,255,430,0.0132777520457002,1.68627450980392,1.68627450980392,0.779540399052407,42,168,37,0.474667400121689,1.21428571428571,1.24390243902439,NA,205,210
"581",49,11.01,5,274,474,0.0126734579289324,1.72992700729927,1.72992700729927,0.743818761159503,39,184,45,0.48877939581871,1.22869955156951,1.19650655021834,NA,229,223
"582",49,11.58,6,280,510,0.0130568356374808,1.82142857142857,1.82142857142857,0.782716766213486,47,186,42,0.468196868896484,1.20171673819742,1.2280701754386,NA,228,233
"583",49,15.06,7,293,547,0.0127869465613166,1.86689419795222,1.86689419795222,0.7390121972373,39,216,30,0.471610099077225,1.14901960784314,1.19105691056911,NA,246,255
"584",49,16.31,8,308,594,0.0125639832480223,1.92857142857143,1.92857142857143,0.709272465162612,31,240,32,0.453999906778336,1.13653136531365,1.13235294117647,NA,272,271
"585",49,17.09,9,319,625,0.0123223122572504,1.95924764890282,1.95924764890282,0.655477097930927,31,237,46,0.456250876188278,1.19029850746269,1.12720848056537,NA,283,268
"586",49,20.67,10,339,705,0.0123055977378646,2.07964601769911,2.07964601769911,0.679447202428545,35,261,41,0.42382875084877,1.14527027027027,1.12251655629139,NA,302,296
"587",49,21.37,11,346,731,0.0122476334087292,2.11271676300578,2.11271676300578,0.688795356785214,35,272,35,0.410906672477722,1.12703583061889,1.12703583061889,NA,307,307
"588",49,21.5,12,349,753,0.0123999604782136,2.15759312320917,2.15759312320917,0.624760464143278,25,280,44,0.42953285574913,1.14426229508197,1.07716049382716,NA,324,305
"589",50,3.58,1,171,218,0.0149982800137599,1.27485380116959,1.27485380116959,0.850979359544859,36,87,39,0.571037769317627,1.39024390243902,1.35714285714286,NA,126,123
"590",50,4.36,2,213,299,0.0132429798919302,1.4037558685446,1.4037558685446,0.843570018569521,41,127,35,0.5544793009758,1.26785714285714,1.31481481481481,NA,162,168
"591",50,7.84,3,238,360,0.0127645995106904,1.51260504201681,1.51260504201681,0.805081015149603,42,146,43,0.546033918857574,1.26595744680851,1.25925925925926,NA,189,188
"592",50,11.08,4,266,421,0.0119449567314513,1.58270676691729,1.58270676691729,0.786554135910886,48,168,44,0.514821588993073,1.23148148148148,1.25471698113208,NA,212,216
"593",50,11.65,5,276,462,0.0121739130434783,1.67391304347826,1.67391304347826,0.776541635876337,42,189,37,0.485626190900803,1.19480519480519,1.2212389380531,NA,226,231
"594",50,12.79,6,281,494,0.0125571936959837,1.75800711743772,1.75800711743772,0.767346307441909,39,184,43,0.46820142865181,1.26008968609865,1.23788546255507,NA,227,223
"595",50,12.92,7,286,523,0.0128327812538339,1.82867132867133,1.82867132867133,0.768322705266971,40,198,43,0.427435487508774,1.20168067226891,1.18672199170124,NA,241,238
"596",50,13.62,8,297,562,0.0127855127855128,1.89225589225589,1.89225589225589,0.760231439837279,40,219,35,0.468465447425842,1.14671814671815,1.16929133858268,NA,254,259
"597",50,16.51,9,318,626,0.0124198956411325,1.9685534591195,1.9685534591195,0.74164396381032,37,231,44,0.462565958499908,1.1865671641791,1.15636363636364,NA,275,268
"598",50,18.73,10,331,686,0.0125606518355763,2.07250755287009,2.07250755287009,0.696824025338888,35,245,40,0.399402022361755,1.18214285714286,1.16140350877193,NA,285,280
"599",50,19.98,11,341,722,0.0124547179575643,2.11730205278592,2.11730205278592,0.679282578279674,33,271,33,0.40604642033577,1.12171052631579,1.12171052631579,NA,304,304
"600",50,21.5,12,349,753,0.0123999604782136,2.15759312320917,2.15759312320917,0.7028716430533,46,268,35,0.460490942001343,1.11146496815287,1.15181518151815,NA,303,314
"601",51,1.14,1,114,141,0.0218910107126223,1.23684210526316,1.23684210526316,0.981727316528779,26,58,19,0.574141144752502,1.35714285714286,1.48051948051948,NA,77,84
"602",51,2.66,2,164,215,0.0160855903037558,1.3109756097561,1.3109756097561,0.817325749715391,16,90,37,0.556289911270142,1.54716981132075,1.29133858267717,NA,127,106
"603",51,3.36,3,205,280,0.0133907221425155,1.36585365853659,1.36585365853659,0.913470043848403,44,108,38,0.554145395755768,1.34868421052632,1.4041095890411,NA,146,152
"604",51,4.14,4,230,335,0.0127207138788684,1.45652173913043,1.45652173913043,0.842783219947144,50,133,38,0.542463779449463,1.2568306010929,1.34502923976608,NA,171,183
"605",51,7.72,5,267,445,0.012531328320802,1.66666666666667,1.66666666666667,0.778083243512278,33,177,43,0.475369304418564,1.27142857142857,1.21363636363636,NA,220,210
"606",51,9.94,6,292,526,0.0123805488866921,1.8013698630137,1.8013698630137,0.74669170314384,42,211,32,0.461277782917023,1.15415019762846,1.20164609053498,NA,243,253
"607",51,13.18,7,305,566,0.0122088006902502,1.85573770491803,1.85573770491803,0.71929489150042,38,213,45,0.491128623485565,1.21513944223108,1.18217054263566,NA,258,251
"608",51,13.75,8,312,598,0.0123258306538049,1.91666666666667,1.91666666666667,0.72699555808091,35,235,33,0.465815544128418,1.15555555555556,1.16417910447761,NA,268,270
"609",51,17.23,9,321,633,0.0123247663551402,1.97196261682243,1.97196261682243,0.701725349010048,44,242,33,0.423841208219528,1.12237762237762,1.16727272727273,NA,275,286
"610",51,17.36,10,325,659,0.0125166191832858,2.02769230769231,2.02769230769231,0.704278255772408,35,255,31,0.430968642234802,1.12068965517241,1.13636363636364,NA,286,290
"611",51,20.25,11,339,717,0.0125150547206367,2.11504424778761,2.11504424778761,0.697930988591025,36,258,40,0.416861683130264,1.1530612244898,1.13758389261745,NA,298,294
"612",51,21.5,12,349,753,0.0123999604782136,2.15759312320917,2.15759312320917,0.654673162143102,34,274,38,0.401797860860825,1.13311688311688,1.11858974358974,NA,312,308
"613",52,3.58,1,171,218,0.0149982800137599,1.27485380116959,1.27485380116959,0.876126727900461,31,92,31,0.590669989585876,1.39024390243902,1.39024390243902,NA,123,123
"614",52,5.1,2,202,274,0.0134968720752672,1.35643564356436,1.35643564356436,0.826024503166291,37,115,40,0.582469761371613,1.32894736842105,1.30322580645161,NA,155,152
"615",52,5.8,3,236,340,0.0122610890732059,1.44067796610169,1.44067796610169,0.817750508938139,38,139,44,0.515549302101135,1.33333333333333,1.2896174863388,NA,183,177
"616",52,8.02,4,273,447,0.0120394311570782,1.63736263736264,1.63736263736264,0.783019311455031,44,185,37,0.489094585180283,1.19213973799127,1.22972972972973,NA,222,229
"617",52,9.27,5,292,507,0.0119333427481994,1.73630136986301,1.73630136986301,0.732484239986226,34,207,43,0.471130102872849,1.21161825726141,1.168,NA,250,241
"618",52,9.84,6,300,544,0.0121293199554069,1.81333333333333,1.81333333333333,0.683677946463511,32,223,37,0.480337023735046,1.17647058823529,1.15384615384615,NA,260,255
"619",52,12.73,7,314,613,0.0124743086221282,1.95222929936306,1.95222929936306,0.717598311971207,36,225,45,0.440584510564804,1.20306513409962,1.16296296296296,NA,270,261
"620",52,13.87,8,319,636,0.0125391849529781,1.99373040752351,1.99373040752351,0.685501873292285,44,236,37,0.459854990243912,1.13928571428571,1.16849816849817,NA,273,280
"621",52,17.35,9,328,666,0.0124188856567465,2.03048780487805,2.03048780487805,0.668057714608121,28,257,37,0.424507826566696,1.15087719298246,1.1156462585034,NA,294,285
"622",52,17.48,10,332,690,0.0125577840061151,2.07831325301205,2.07831325301205,0.680443601285978,33,256,37,0.40470278263092,1.14878892733564,1.13310580204778,NA,293,289
"623",52,20.72,11,342,727,0.0124676304642349,2.12573099415205,2.12573099415205,0.649284990590538,26,281,28,0.457294672727585,1.11400651465798,1.10679611650485,NA,309,307
"624",52,21.5,12,349,753,0.0123999604782136,2.15759312320917,2.15759312320917,0.7028716430533,36,272,35,0.441296339035034,1.13311688311688,1.13680781758958,NA,307,308
"625",53,2.22,1,171,214,0.0147230822153423,1.25146198830409,1.25146198830409,0.875733702038254,36,92,35,0.649052321910858,1.3359375,1.34645669291339,NA,127,128
"626",53,5.11,2,224,340,0.013613068545804,1.51785714285714,1.51785714285714,0.843946331799506,42,134,32,0.521224081516266,1.27272727272727,1.34939759036145,NA,166,176
"627",53,5.68,3,240,392,0.0136680613668061,1.63333333333333,1.63333333333333,0.813289543287653,38,149,40,0.457950443029404,1.28342245989305,1.26984126984127,NA,189,187
"628",53,9.16,4,259,439,0.0131393852324085,1.69498069498069,1.69498069498069,0.765987759610272,43,168,40,0.480985462665558,1.22748815165877,1.24519230769231,NA,208,211
"629",53,9.94,5,272,477,0.0129422617755589,1.75367647058824,1.75367647058824,0.743325382809548,39,193,34,0.465694457292557,1.17241379310345,1.19823788546256,NA,227,232
"630",53,11.08,6,276,500,0.0131752305665349,1.81159420289855,1.81159420289855,0.780789865806066,44,184,38,0.441626012325287,1.21052631578947,1.24324324324324,NA,222,228
"631",53,12.33,7,295,547,0.0126138591029632,1.85423728813559,1.85423728813559,0.712207138046689,35,214,37,0.449500173330307,1.18473895582329,1.17529880478088,NA,251,249
"632",53,13.85,8,308,586,0.0123947713524261,1.9025974025974,1.9025974025974,0.745167520236973,42,222,35,0.443222939968109,1.16666666666667,1.19844357976654,NA,257,264
"633",53,13.98,9,312,610,0.0125731717371589,1.95512820512821,1.95512820512821,0.731069272424326,36,236,32,0.427958846092224,1.14705882352941,1.16417910447761,NA,268,272
"634",53,17.56,10,334,689,0.0123896351441262,2.06287425149701,2.06287425149701,0.737944413515105,41,245,42,0.428740233182907,1.16783216783217,1.16376306620209,NA,287,286
"635",53,20.8,11,343,727,0.0123949329105076,2.11953352769679,2.11953352769679,0.653478623484099,34,268,38,0.435692310333252,1.13576158940397,1.12091503267974,NA,306,302
"636",53,21.5,12,349,753,0.0123999604782136,2.15759312320917,2.15759312320917,0.736326235992663,42,260,41,0.397859662771225,1.15562913907285,1.15946843853821,NA,301,302
"637",54,0.78,1,137,147,0.0157793044224989,1.07299270072993,1.07299270072993,0.901564753721596,30,65,29,0.641168057918549,1.44210526315789,1.45744680851064,NA,94,95
"638",54,1.92,2,164,221,0.0165344904982792,1.34756097560976,1.34756097560976,0.812055045046157,29,90,35,0.532759368419647,1.3781512605042,1.312,NA,125,119
"639",54,4.81,3,216,332,0.0142980189491817,1.53703703703704,1.53703703703704,0.836836532174813,37,140,31,0.535368859767914,1.22033898305085,1.26315789473684,NA,171,177
"640",54,6.33,4,247,383,0.0126065633125967,1.55060728744939,1.55060728744939,0.736821943385723,33,164,41,0.510368883609772,1.25380710659898,1.20487804878049,NA,205,197
"641",54,6.9,5,254,426,0.0132582241449068,1.67716535433071,1.67716535433071,0.834445089801059,48,167,31,0.479889899492264,1.18139534883721,1.28282828282828,NA,198,215
"642",54,10.14,6,276,474,0.0124901185770751,1.71739130434783,1.71739130434783,0.820433570636572,45,179,41,0.487399637699127,1.23214285714286,1.25454545454545,NA,220,224
"643",54,13.72,7,302,565,0.01243096961563,1.87086092715232,1.87086092715232,0.681957241289985,27,229,40,0.417861998081207,1.1796875,1.12267657992565,NA,269,256
"644",54,13.85,8,308,593,0.0125428317610728,1.92532467532468,1.92532467532468,0.68839068662853,34,229,41,0.490190476179123,1.17110266159696,1.14074074074074,NA,270,263
"645",54,17.33,9,319,625,0.0123223122572504,1.95924764890282,1.95924764890282,0.691955713128245,35,244,36,0.466878712177277,1.14336917562724,1.13928571428571,NA,280,279
"646",54,18.58,10,332,667,0.0121391912059113,2.00903614457831,2.00903614457831,0.694814676828178,42,247,36,0.419192224740982,1.14878892733564,1.17314487632509,NA,283,289
"647",54,20.8,11,343,727,0.0123949329105076,2.11953352769679,2.11953352769679,0.700585064770976,45,254,40,0.436236202716827,1.14715719063545,1.16666666666667,NA,294,299
"648",54,21.5,12,349,753,0.0123999604782136,2.15759312320917,2.15759312320917,0.675097944697303,41,271,34,0.408437937498093,1.11858974358974,1.14426229508197,NA,305,312
"649",55,1.14,1,114,141,0.0218910107126223,1.23684210526316,1.23684210526316,0.939574611348053,34,53,23,0.588677644729614,1.31034482758621,1.5,NA,76,87
"650",55,1.84,2,163,220,0.0166628796485647,1.34969325153374,1.34969325153374,0.813017433521243,28,88,38,0.566136360168457,1.4051724137931,1.29365079365079,NA,126,116
"651",55,5.42,3,226,349,0.0137266470009833,1.54424778761062,1.54424778761062,0.78192797882786,38,141,38,0.542852759361267,1.26256983240223,1.26256983240223,NA,179,179
"652",55,6.94,4,246,394,0.0130744980919197,1.60162601626016,1.60162601626016,0.790732622149984,49,156,35,0.501365721225739,1.2,1.28795811518325,NA,191,205
"653",55,9.16,5,279,483,0.0124545524870426,1.73118279569892,1.73118279569892,0.725750158374519,41,189,44,0.465724885463715,1.21304347826087,1.19742489270386,NA,233,230
"654",55,10.41,6,298,539,0.0121799652000994,1.80872483221477,1.80872483221477,0.688135754722627,33,215,41,0.466427564620972,1.20161290322581,1.1640625,NA,256,248
"655",55,13.3,7,314,608,0.0123725605909526,1.93630573248408,1.93630573248408,0.704670580945097,36,241,30,0.459242701530457,1.13357400722022,1.15867158671587,NA,271,277
"656",55,14.08,8,325,638,0.0121177587844255,1.96307692307692,1.96307692307692,0.731196879434536,36,243,36,0.449132084846497,1.16487455197133,1.16487455197133,NA,279,279
"657",55,14.65,9,328,664,0.0123815917058253,2.02439024390244,2.02439024390244,0.690964383035248,32,260,30,0.426616489887238,1.12328767123288,1.13103448275862,NA,290,292
"658",55,17.89,10,337,701,0.012381658895012,2.08011869436202,2.08011869436202,0.691327206559603,35,268,27,0.432187765836716,1.11221122112211,1.14237288135593,NA,295,303
"659",55,21.37,11,346,731,0.0122476334087292,2.11271676300578,2.11271676300578,0.648991488557063,38,264,39,0.39659795165062,1.14569536423841,1.14191419141914,NA,303,302
"660",55,21.5,12,349,753,0.0123999604782136,2.15759312320917,2.15759312320917,0.665891620703834,31,288,28,0.410842657089233,1.09404388714734,1.10443037974684,NA,316,319
"661",56,0.13,1,110,118,0.0196830692243536,1.07272727272727,1.07272727272727,1.0157692839381,27,46,25,0.641625881195068,1.50684931506849,1.54929577464789,NA,71,73
"662",56,0.7,2,168,219,0.0156116338751069,1.30357142857143,1.30357142857143,0.851004218335601,40,81,40,0.577594220638275,1.38842975206612,1.38842975206612,NA,121,121
"663",56,3.94,3,206,295,0.0139711105848923,1.43203883495146,1.43203883495146,0.864992044650791,49,110,41,0.535300195217133,1.29559748427673,1.36423841059603,NA,151,159
"664",56,5.08,4,214,338,0.0148304155148962,1.57943925233645,1.57943925233645,0.677852527992861,25,143,38,0.500603973865509,1.27380952380952,1.18232044198895,NA,181,168
"665",56,8.66,5,260,446,0.0132462132462132,1.71538461538462,1.71538461538462,0.727123145536733,30,177,42,0.499924600124359,1.256038647343,1.18721461187215,NA,219,207
"666",56,9.44,6,275,485,0.0128732581287326,1.76363636363636,1.76363636363636,0.703371396810633,33,187,49,0.491182893514633,1.25,1.16525423728814,NA,236,220
"667",56,10.69,7,292,538,0.012662994868898,1.84246575342466,1.84246575342466,0.746676846221058,38,215,31,0.457979738712311,1.15415019762846,1.1869918699187,NA,246,253
"668",56,14.17,8,302,573,0.0126069833447009,1.89735099337748,1.89735099337748,0.709729656115379,39,222,36,0.472503215074539,1.15708812260536,1.17054263565891,NA,258,261
"669",56,15.69,9,313,607,0.0124313918243631,1.93929712460064,1.93929712460064,0.7418960409554,51,219,37,0.458636105060577,1.15925925925926,1.22265625,NA,256,270
"670",56,16.39,10,321,639,0.0124415887850467,1.99065420560748,1.99065420560748,0.729578541065423,42,234,40,0.467573314905167,1.16304347826087,1.17153284671533,NA,274,276
"671",56,19.28,11,338,695,0.0122030446157358,2.05621301775148,2.05621301775148,0.71181162640758,36,259,34,0.408244907855988,1.14576271186441,1.15358361774744,NA,293,295
"672",56,21.5,12,349,753,0.0123999604782136,2.15759312320917,2.15759312320917,0.699349921601532,32,279,34,0.417714685201645,1.12218649517685,1.11501597444089,NA,313,311
"673",57,2.89,1,163,202,0.015299553131864,1.23926380368098,1.23926380368098,0.785907535244627,33,83,41,0.639876008033752,1.4051724137931,1.31451612903226,NA,124,116
"674",57,6.37,2,206,286,0.0135448733128108,1.38834951456311,1.38834951456311,0.875582072074545,37,116,39,0.546738266944885,1.34640522875817,1.32903225806452,NA,155,153
"675",57,9.61,3,247,360,0.0118495112076627,1.45748987854251,1.45748987854251,0.812881948767309,48,146,46,0.585258424282074,1.27319587628866,1.28645833333333,NA,192,194
"676",57,10.39,4,266,406,0.011519364448858,1.52631578947368,1.52631578947368,0.784882858211991,44,167,44,0.514538705348969,1.260663507109,1.260663507109,NA,211,211
"677",57,10.96,5,273,450,0.012120232708468,1.64835164835165,1.64835164835165,0.761219996028048,42,176,44,0.501696348190308,1.25229357798165,1.24090909090909,NA,220,218
"678",57,12.48,6,287,486,0.0118418167198655,1.69337979094077,1.69337979094077,0.769026455198635,45,194,39,0.483155936002731,1.20083682008368,1.23175965665236,NA,233,239
"679",57,13.62,7,291,512,0.012134139116009,1.75945017182131,1.75945017182131,0.735135168200828,34,203,42,0.456655502319336,1.22784810126582,1.18775510204082,NA,245,237
"680",57,13.75,8,295,541,0.0124754986740459,1.83389830508475,1.83389830508475,0.715971163464726,36,217,38,0.462614625692368,1.16600790513834,1.15686274509804,NA,255,253
"681",57,14.45,9,306,575,0.0123218686381656,1.87908496732026,1.87908496732026,0.736725381472953,39,217,44,0.453908562660217,1.1953125,1.17241379310345,NA,261,256
"682",57,18.03,10,327,657,0.0123262227725559,2.00917431192661,2.00917431192661,0.680256053956017,44,239,41,0.439749658107758,1.15547703180212,1.16785714285714,NA,280,283
"683",57,19.28,11,338,695,0.0122030446157358,2.05621301775148,2.05621301775148,0.659612619694587,34,260,39,0.458278506994247,1.14965986394558,1.1304347826087,NA,299,294
"684",57,21.5,12,349,753,0.0123999604782136,2.15759312320917,2.15759312320917,0.646131506166198,29,272,41,0.42167142033577,1.15946843853821,1.11501597444089,NA,313,301
"685",58,0.78,1,137,147,0.0157793044224989,1.07299270072993,1.07299270072993,0.894452832008268,28,55,36,0.606969356536865,1.65060240963855,1.50549450549451,NA,91,83
"686",58,1.35,2,185,236,0.0138660399529965,1.27567567567568,1.27567567567568,0.885788006630681,40,93,40,0.588166117668152,1.39097744360902,1.39097744360902,NA,133,133
"687",58,2.05,3,210,294,0.0133971291866029,1.4,1.4,0.889895978227359,42,111,45,0.566685199737549,1.37254901960784,1.34615384615385,NA,156,153
"688",58,3.57,4,233,342,0.012653544472399,1.46781115879828,1.46781115879828,0.795124732083981,38,142,41,0.538888037204742,1.29444444444444,1.27322404371585,NA,183,180
"689",58,6.46,5,265,434,0.0124070897655803,1.6377358490566,1.6377358490566,0.810558944208883,44,164,50,0.499256730079651,1.27403846153846,1.23831775700935,NA,214,208
"690",58,8.68,6,285,511,0.0126266370150729,1.79298245614035,1.79298245614035,0.775293758638524,39,197,40,0.491827547550201,1.20762711864407,1.20253164556962,NA,237,236
"691",58,9.82,7,290,536,0.0127908364157022,1.84827586206897,1.84827586206897,0.743210176350453,41,200,44,0.448885470628738,1.20331950207469,1.18852459016393,NA,244,241
"692",58,13.3,8,302,571,0.0125629799124332,1.89072847682119,1.89072847682119,0.752552301080874,41,223,29,0.456776887178421,1.14393939393939,1.1984126984127,NA,252,264
"693",58,16.54,9,315,611,0.0123546658578506,1.93968253968254,1.93968253968254,0.760827506089868,47,221,42,0.459005802869797,1.17537313432836,1.19771863117871,NA,263,268
"694",58,17.79,10,326,651,0.0122888154789995,1.99693251533742,1.99693251533742,0.763251250612107,41,244,36,0.439463317394257,1.14385964912281,1.16428571428571,NA,280,285
"695",58,21.37,11,346,731,0.0122476334087292,2.11271676300578,2.11271676300578,0.675467561755716,38,267,37,0.406228214502335,1.1344262295082,1.13815789473684,NA,304,305
"696",58,21.5,12,349,753,0.0123999604782136,2.15759312320917,2.15759312320917,0.685082022670687,39,265,44,0.409355938434601,1.14802631578947,1.1294498381877,NA,309,304
"697",59,0.78,1,137,147,0.0157793044224989,1.07299270072993,1.07299270072993,0.96981976150612,25,60,29,0.577421426773071,1.61176470588235,1.53932584269663,NA,89,85
"698",59,1.35,2,185,236,0.0138660399529965,1.27567567567568,1.27567567567568,0.819189914882771,29,106,35,0.580777823925018,1.37037037037037,1.31205673758865,NA,141,135
"699",59,4.93,3,238,361,0.0128000567315534,1.51680672268908,1.51680672268908,0.834186202098638,39,152,33,0.504335403442383,1.24607329842932,1.28648648648649,NA,185,191
"700",59,8.17,4,261,416,0.0122605363984674,1.59386973180077,1.59386973180077,0.726845696254774,36,173,47,0.508390367031097,1.2488038277512,1.18636363636364,NA,220,209
"701",59,11.06,5,288,502,0.0121467286101432,1.74305555555556,1.74305555555556,0.765512647278368,38,195,41,0.463327944278717,1.23605150214592,1.22033898305085,NA,236,233
"702",59,12.58,6,297,538,0.0122395122395122,1.81144781144781,1.81144781144781,0.738307253102572,39,205,43,0.466309547424316,1.2172131147541,1.19758064516129,NA,248,244
"703",59,13.83,7,312,588,0.0121197130843433,1.88461538461538,1.88461538461538,0.676715773521121,34,227,43,0.464446187019348,1.19540229885057,1.15555555555556,NA,270,261
"704",59,17.31,8,324,620,0.0118487940985361,1.91358024691358,1.91358024691358,0.739944005283889,48,228,42,0.420872747898102,1.17391304347826,1.2,NA,270,276
"705",59,17.44,9,328,645,0.0120272991720743,1.96646341463415,1.96646341463415,0.734739328787969,36,240,39,0.436536252498627,1.18840579710145,1.17562724014337,NA,279,276
"706",59,18.14,10,335,674,0.0120475466976495,2.01194029850746,2.01194029850746,0.693349807194398,35,257,37,0.438922584056854,1.1472602739726,1.13945578231292,NA,294,292
"707",59,19.28,11,338,695,0.0122030446157358,2.05621301775148,2.05621301775148,0.704875965753434,36,256,39,0.431705385446548,1.15753424657534,1.14576271186441,NA,295,292
"708",59,21.5,12,349,753,0.0123999604782136,2.15759312320917,2.15759312320917,0.679654343868995,30,278,31,0.406684875488281,1.13311688311688,1.1294498381877,NA,309,308
"709",60,0.78,1,137,147,0.0157793044224989,1.07299270072993,1.07299270072993,1.02114419233111,37,50,37,0.605025708675385,1.57471264367816,1.57471264367816,NA,87,87
"710",60,1.92,2,164,221,0.0165344904982792,1.34756097560976,1.34756097560976,0.836644855363769,32,90,34,0.540386140346527,1.34426229508197,1.32258064516129,NA,124,122
"711",60,5.5,3,230,354,0.0134421872033416,1.53913043478261,1.53913043478261,0.764606000984462,35,145,43,0.500845849514008,1.27777777777778,1.22340425531915,NA,188,180
"712",60,6.07,4,246,402,0.0133399701343952,1.63414634146341,1.63414634146341,0.724134751631221,40,159,40,0.505479454994202,1.23618090452261,1.23618090452261,NA,199,199
"713",60,8.29,5,275,478,0.0126874585268746,1.73818181818182,1.73818181818182,0.811497454559932,42,184,39,0.491141587495804,1.21681415929204,1.23318385650224,NA,223,226
"714",60,11.18,6,295,552,0.0127291594603943,1.87118644067797,1.87118644067797,0.726358808339588,44,211,35,0.454747915267944,1.15686274509804,1.19918699186992,NA,246,255
"715",60,12.7,7,305,591,0.0127480586712683,1.93770491803279,1.93770491803279,0.701572844150497,37,226,38,0.458579212427139,1.15969581749049,1.15530303030303,NA,264,263
"716",60,13.95,8,320,635,0.0124412225705329,1.984375,1.984375,0.681217957904986,35,249,34,0.445014506578445,1.12676056338028,1.13074204946996,NA,283,284
"717",60,17.43,9,330,667,0.0122870037763655,2.02121212121212,2.02121212121212,0.66638207631393,34,252,42,0.454499840736389,1.15384615384615,1.12244897959184,NA,294,286
"718",60,18.13,10,337,694,0.0122580189345768,2.0593471810089,2.0593471810089,0.676854323887394,38,257,35,0.420342326164246,1.14237288135593,1.1541095890411,NA,292,295
"719",60,18.26,11,340,716,0.012424084678119,2.10588235294118,2.10588235294118,0.668669476917864,33,276,29,0.41572317481041,1.10032362459547,1.11475409836066,NA,305,309
"720",60,21.5,12,349,753,0.0123999604782136,2.15759312320917,2.15759312320917,0.676011681389913,31,281,36,0.404331296682358,1.11858974358974,1.10094637223975,NA,317,312
"721",61,1.52,1,120,123,0.0172268907563025,1.025,1.025,1.03111234956619,23,58,20,0.647960841655731,1.48148148148148,1.53846153846154,NA,78,81
"722",61,4.76,2,196,235,0.0122972265829409,1.19897959183673,1.19897959183673,0.935333256779915,45,97,35,0.558279752731323,1.38028169014085,1.48484848484848,NA,132,142
"723",61,7.65,3,249,354,0.0114652157015157,1.42168674698795,1.42168674698795,0.841230194711579,44,148,39,0.507564842700958,1.296875,1.33155080213904,NA,187,192
"724",61,8.79,4,255,391,0.0120734908136483,1.53333333333333,1.53333333333333,0.780151339999152,38,172,35,0.509595692157745,1.21428571428571,1.23188405797101,NA,207,210
"725",61,8.92,5,264,427,0.0122998041248992,1.61742424242424,1.61742424242424,0.755162571513212,39,177,39,0.53700453042984,1.22222222222222,1.22222222222222,NA,216,216
"726",61,11.14,6,282,505,0.0127457661341208,1.79078014184397,1.79078014184397,0.742390534335013,39,193,41,0.488801032304764,1.21551724137931,1.20512820512821,NA,234,232
"727",61,11.92,7,293,539,0.0125999345457946,1.83959044368601,1.83959044368601,0.727829227056495,37,205,41,0.482743054628372,1.21074380165289,1.19105691056911,NA,246,242
"728",61,15.5,8,317,626,0.01249850257557,1.97476340694006,1.97476340694006,0.718291956267721,35,237,41,0.416661143302917,1.16544117647059,1.14028776978417,NA,278,272
"729",61,16.75,9,331,670,0.0122676920260002,2.02416918429003,2.02416918429003,0.68141105594002,43,240,45,0.418597668409348,1.16961130742049,1.16140350877193,NA,285,283
"730",61,20.23,10,340,700,0.0121464515009544,2.05882352941176,2.05882352941176,0.73336671680408,32,262,33,0.417968392372131,1.15646258503401,1.15254237288136,NA,295,294
"731",61,20.93,11,346,727,0.0121806148948647,2.10115606936416,2.10115606936416,0.676692945733195,36,262,45,0.420626878738403,1.16107382550336,1.12703583061889,NA,307,298
"732",61,21.5,12,349,753,0.0123999604782136,2.15759312320917,2.15759312320917,0.694922672416577,38,272,31,0.428613096475601,1.1258064516129,1.15181518151815,NA,303,310
"733",62,1.52,1,120,123,0.0172268907563025,1.025,1.025,0.999602498493664,31,49,25,0.682827711105347,1.5,1.62162162162162,NA,74,80
"734",62,1.65,2,167,202,0.0145732631123296,1.20958083832335,1.20958083832335,0.933544974264505,38,85,29,0.585248947143555,1.35772357723577,1.46491228070175,NA,114,123
"735",62,3.87,3,222,326,0.0132893074069545,1.46846846846847,1.46846846846847,0.8387694319204,43,124,44,0.544934928417206,1.32934131736527,1.32142857142857,NA,168,167
"736",62,7.11,4,245,390,0.0130478420876547,1.59183673469388,1.59183673469388,0.772730060899128,37,166,34,0.527971744537354,1.20689655172414,1.225,NA,200,203
"737",62,7.89,5,261,433,0.0127615679339817,1.65900383141762,1.65900383141762,0.779357015144666,39,177,30,0.477956026792526,1.20833333333333,1.26086956521739,NA,207,216
"738",62,9.03,6,265,461,0.0131789594053745,1.73962264150943,1.73962264150943,0.710254194511906,35,191,32,0.481251209974289,1.17256637168142,1.18834080717489,NA,223,226
"739",62,9.6,7,273,497,0.0133861236802413,1.82051282051282,1.82051282051282,0.723747632220482,40,193,33,0.441004157066345,1.17167381974249,1.20796460176991,NA,226,233
"740",62,12.49,8,297,572,0.013013013013013,1.92592592592593,1.92592592592593,0.746829818437039,37,216,32,0.452656626701355,1.17391304347826,1.19758064516129,NA,248,253
"741",62,16.07,9,321,655,0.0127531152647975,2.0404984423676,2.0404984423676,0.678004227518582,27,256,32,0.425146549940109,1.13427561837456,1.11458333333333,NA,288,283
"742",62,19.55,10,331,687,0.0125789618236748,2.07552870090634,2.07552870090634,0.733629407666542,35,247,43,0.409370094537735,1.17375886524823,1.14137931034483,NA,290,282
"743",62,20.25,11,339,717,0.0125150547206367,2.11504424778761,2.11504424778761,0.684535834982606,39,264,30,0.448186039924622,1.11881188118812,1.1530612244898,NA,294,303
"744",62,21.5,12,349,753,0.0123999604782136,2.15759312320917,2.15759312320917,0.658433886578466,33,276,32,0.412884086370468,1.1294498381877,1.13311688311688,NA,308,309
"745",63,0.13,1,110,118,0.0196830692243536,1.07272727272727,1.07272727272727,1.02358792993198,28,44,26,0.630027294158936,1.52777777777778,1.57142857142857,NA,70,72
"746",63,0.91,2,167,203,0.0146454079792223,1.21556886227545,1.21556886227545,0.912507159908951,37,79,41,0.624208331108093,1.43965517241379,1.39166666666667,NA,120,116
"747",63,4.15,3,213,293,0.0129772344760386,1.37558685446009,1.37558685446009,0.804991904134554,36,119,44,0.569045662879944,1.3741935483871,1.30674846625767,NA,163,155
"748",63,5.29,4,222,336,0.0136969548734255,1.51351351351351,1.51351351351351,0.81644768787627,41,134,38,0.506700813770294,1.26857142857143,1.2906976744186,NA,172,175
"749",63,7.51,5,247,417,0.0137256838155426,1.68825910931174,1.68825910931174,0.731318625288065,35,164,38,0.478975087404251,1.24120603015075,1.22277227722772,NA,202,199
"750",63,9.03,6,265,461,0.0131789594053745,1.73962264150943,1.73962264150943,0.749691488122195,39,176,42,0.495193421840668,1.23255813953488,1.21559633027523,NA,218,215
"751",63,10.28,7,287,516,0.0125727930605979,1.79790940766551,1.79790940766551,0.679041032316665,36,208,35,0.479487776756287,1.17622950819672,1.18106995884774,NA,243,244
"752",63,10.85,8,292,549,0.0129219036859201,1.88013698630137,1.88013698630137,0.759136487829376,46,201,40,0.451692283153534,1.18218623481781,1.21161825726141,NA,241,247
"753",63,13.74,9,312,616,0.0126968422788358,1.97435897435897,1.97435897435897,0.703388172666558,42,233,33,0.444715589284897,1.13454545454545,1.17293233082707,NA,266,275
"754",63,17.22,10,323,649,0.0124800492279292,2.00928792569659,2.00928792569659,0.661569369037325,27,250,38,0.434030324220657,1.16606498194946,1.12152777777778,NA,288,277
"755",63,20.8,11,343,727,0.0123949329105076,2.11953352769679,2.11953352769679,0.700585064770976,44,268,26,0.396674573421478,1.09935897435897,1.16666666666667,NA,294,312
"756",63,21.5,12,349,753,0.0123999604782136,2.15759312320917,2.15759312320917,0.685082022670687,36,282,26,0.387690514326096,1.09748427672956,1.13311688311688,NA,308,318
"757",64,1.52,1,120,123,0.0172268907563025,1.025,1.025,0.933397080629956,27,55,24,0.647828638553619,1.46341463414634,1.51898734177215,NA,79,82
"758",64,2.22,2,193,223,0.0120358376511226,1.15544041450777,1.15544041450777,0.877416624244618,36,89,46,0.642753720283508,1.544,1.42962962962963,NA,135,125
"759",64,5.8,3,236,340,0.0122610890732059,1.44067796610169,1.44067796610169,0.81523952015735,42,139,43,0.580709397792816,1.30386740331492,1.2967032967033,NA,182,181
"760",64,8.69,4,268,444,0.012409860808318,1.65671641791045,1.65671641791045,0.797781209060395,44,176,40,0.495665431022644,1.21818181818182,1.24074074074074,NA,216,220
"761",64,9.47,5,287,489,0.0119149143539387,1.70383275261324,1.70383275261324,0.795812873134277,47,185,48,0.50022166967392,1.23706896551724,1.23175965665236,NA,233,232
"762",64,10.04,6,292,529,0.0124511603822436,1.81164383561644,1.81164383561644,0.719656880703552,30,210,49,0.470676213502884,1.21666666666667,1.12741312741313,NA,259,240
"763",64,10.17,7,297,556,0.0126490126490126,1.87205387205387,1.87205387205387,0.69504750763085,36,217,39,0.455425769090652,1.17391304347826,1.16015625,NA,256,253
"764",64,11.31,8,302,585,0.0128710039383072,1.93708609271523,1.93708609271523,0.706532510433665,36,223,39,0.435494184494019,1.16602316602317,1.15267175572519,NA,262,259
"765",64,13.53,9,319,648,0.0127757733483173,2.03134796238245,2.03134796238245,0.74571053559285,41,238,36,0.430496037006378,1.14336917562724,1.16423357664234,NA,274,279
"766",64,16.77,10,330,685,0.0126185870866722,2.07575757575758,2.07575757575758,0.662989128634487,34,258,37,0.446496874094009,1.13013698630137,1.11864406779661,NA,295,292
"767",64,18.02,11,340,723,0.0125455491931286,2.12647058823529,2.12647058823529,0.651956419674177,31,273,31,0.430964291095734,1.11842105263158,1.11842105263158,NA,304,304
"768",64,21.5,12,349,753,0.0123999604782136,2.15759312320917,2.15759312320917,0.652784675331965,27,285,32,0.430958807468414,1.11858974358974,1.10094637223975,NA,317,312
"769",65,0.57,1,142,160,0.0159824193387274,1.12676056338028,1.12676056338028,0.962152811103773,32,66,28,0.610664069652557,1.44897959183673,1.51063829787234,NA,94,98
"770",65,3.46,2,206,299,0.014160549372484,1.45145631067961,1.45145631067961,0.901533084428702,40,119,36,0.531470596790314,1.29559748427673,1.32903225806452,NA,155,159
"771",65,5.68,3,240,392,0.0136680613668061,1.63333333333333,1.63333333333333,0.732099138191581,28,165,35,0.464881151914597,1.24352331606218,1.2,NA,200,193
"772",65,6.93,4,263,450,0.0130612718776304,1.71102661596958,1.71102661596958,0.787795345241615,40,173,43,0.492864191532135,1.23474178403756,1.21759259259259,NA,216,213
"773",65,8.07,5,268,476,0.0133042651908994,1.77611940298507,1.77611940298507,0.750621592829446,34,194,31,0.448392629623413,1.17543859649123,1.19111111111111,NA,225,228
"774",65,9.59,6,284,520,0.0129398297914697,1.83098591549296,1.83098591549296,0.761304913655374,44,193,37,0.474252969026566,1.19831223628692,1.23478260869565,NA,230,237
"775",65,9.72,7,292,548,0.0128983665207362,1.87671232876712,1.87671232876712,0.78249936616505,34,217,31,0.46670538187027,1.16334661354582,1.17741935483871,NA,248,251
"776",65,13.2,8,303,582,0.0127204773457478,1.92079207920792,1.92079207920792,0.76969862910224,43,218,39,0.446841686964035,1.16091954022989,1.17898832684825,NA,257,261
"777",65,16.44,9,315,621,0.0125568698817106,1.97142857142857,1.97142857142857,0.68387129051564,36,235,42,0.450889587402344,1.16236162361624,1.13718411552347,NA,277,271
"778",65,20.02,10,336,700,0.0124378109452736,2.08333333333333,2.08333333333333,0.678653627610327,31,267,31,0.430904060602188,1.12751677852349,1.12751677852349,NA,298,298
"779",65,20.72,11,342,727,0.0124676304642349,2.12573099415205,2.12573099415205,0.69280508763455,35,268,33,0.432333916425705,1.12871287128713,1.13621262458472,NA,301,303
"780",65,21.5,12,349,753,0.0123999604782136,2.15759312320917,2.15759312320917,0.685082022670687,38,276,30,0.444837749004364,1.11146496815287,1.14052287581699,NA,306,314
"781",66,0.57,1,142,160,0.0159824193387274,1.12676056338028,1.12676056338028,0.870719010786305,27,66,32,0.621601581573486,1.52688172043011,1.44897959183673,NA,98,93
"782",66,4.15,2,212,302,0.0135026379325762,1.42452830188679,1.42452830188679,0.822680542386308,37,121,37,0.526018619537354,1.34177215189873,1.34177215189873,NA,158,158
"783",66,4.28,3,228,349,0.0134863590694799,1.53070175438596,1.53070175438596,0.805138748847777,37,138,42,0.50708943605423,1.30285714285714,1.26666666666667,NA,180,175
"784",66,4.98,4,249,402,0.0130198212203653,1.6144578313253,1.6144578313253,0.816544801906048,55,155,35,0.497054517269135,1.18571428571429,1.31052631578947,NA,190,210
"785",66,6.23,5,265,462,0.0132075471698113,1.74339622641509,1.74339622641509,0.79296578042659,42,171,42,0.467042863368988,1.24413145539906,1.24413145539906,NA,213,213
"786",66,9.47,6,287,516,0.0125727930605979,1.79790940766551,1.79790940766551,0.757358124600411,41,194,43,0.454915553331375,1.22127659574468,1.21097046413502,NA,237,235
"787",66,10.61,7,291,542,0.0128451238298377,1.86254295532646,1.86254295532646,0.739731381182119,35,206,45,0.438513547182083,1.20746887966805,1.1593625498008,NA,251,241
"788",66,13.5,8,311,605,0.0125505652940566,1.94533762057878,1.94533762057878,0.734018507714316,43,216,45,0.41995632648468,1.2007722007722,1.19157088122605,NA,261,259
"789",66,15.72,9,325,664,0.0126115859449193,2.04307692307692,2.04307692307692,0.7024814758307,36,252,31,0.442756325006485,1.12847222222222,1.14840989399293,NA,283,288
"790",66,17.24,10,333,697,0.0126089945367054,2.09309309309309,2.09309309309309,0.678760867704926,37,262,32,0.407243400812149,1.11371237458194,1.13265306122449,NA,294,299
"791",66,18.02,11,340,723,0.0125455491931286,2.12647058823529,2.12647058823529,0.685132879436621,39,264,35,0.404476314783096,1.12211221122112,1.1371237458194,NA,299,303
"792",66,21.5,12,349,753,0.0123999604782136,2.15759312320917,2.15759312320917,0.694922672416577,38,271,37,0.393745929002762,1.1294498381877,1.13311688311688,NA,308,309
"793",67,1.25,1,132,163,0.018852648623641,1.23484848484848,1.23484848484848,0.937909428705459,26,59,35,0.530787765979767,1.55294117647059,1.40425531914894,NA,94,85
"794",67,1.82,2,186,257,0.0149375181633246,1.38172043010753,1.38172043010753,0.792629995495616,36,106,32,0.538804531097412,1.30985915492958,1.34782608695652,NA,138,142
"795",67,4.71,3,233,361,0.01335651916531,1.54935622317597,1.54935622317597,0.778679859393276,40,139,43,0.51206636428833,1.30167597765363,1.28021978021978,NA,182,179
"796",67,6.93,4,263,450,0.0130612718776304,1.71102661596958,1.71102661596958,0.779476927473591,38,177,38,0.439338237047195,1.22325581395349,1.22325581395349,NA,215,215
"797",67,7.63,5,274,485,0.0129675677120933,1.77007299270073,1.77007299270073,0.752628975426161,42,185,42,0.488421738147736,1.20704845814978,1.20704845814978,NA,227,227
"798",67,8.41,6,284,517,0.0128651769272881,1.82042253521127,1.82042253521127,0.709304425971844,26,206,39,0.451122134923935,1.22413793103448,1.15918367346939,NA,245,232
"799",67,11.99,7,313,606,0.0124109117719341,1.93610223642173,1.93610223642173,0.721446168582182,36,249,23,0.442780703306198,1.09824561403509,1.15073529411765,NA,272,285
"800",67,13.13,8,318,627,0.0124397357300161,1.97169811320755,1.97169811320755,0.738848300563028,31,242,35,0.448112428188324,1.16483516483516,1.14801444043321,NA,277,273
"801",67,14.65,9,328,664,0.0123815917058253,2.02439024390244,2.02439024390244,0.717455581587932,39,249,36,0.440332889556885,1.13888888888889,1.15087719298246,NA,285,288
"802",67,17.89,10,337,701,0.012381658895012,2.08011869436202,2.08011869436202,0.683321257546767,32,266,33,0.425617784261703,1.13087248322148,1.12709030100334,NA,299,298
"803",67,18.02,11,340,723,0.0125455491931286,2.12647058823529,2.12647058823529,0.696464998412421,39,259,41,0.431781083345413,1.14093959731544,1.13333333333333,NA,300,298
"804",67,21.5,12,349,753,0.0123999604782136,2.15759312320917,2.15759312320917,0.654673162143102,34,275,37,0.426722496747971,1.1294498381877,1.11858974358974,NA,312,309
"805",68,2.89,1,163,202,0.015299553131864,1.23926380368098,1.23926380368098,0.85451323937861,28,88,35,0.592613518238068,1.4051724137931,1.32520325203252,NA,123,116
"806",68,4.03,2,189,274,0.0154227175503771,1.44973544973545,1.44973544973545,0.747488975046069,28,112,41,0.546099960803986,1.35,1.23529411764706,NA,153,140
"807",68,5.28,3,218,339,0.0143322200143745,1.55504587155963,1.55504587155963,0.811828314102017,36,134,37,0.507570445537567,1.28235294117647,1.27485380116959,NA,171,170
"808",68,5.98,4,235,391,0.0142207674122568,1.66382978723404,1.66382978723404,0.724945061391965,31,161,33,0.510671675205231,1.22395833333333,1.21134020618557,NA,194,192
"809",68,9.46,5,256,435,0.0133272058823529,1.69921875,1.69921875,0.746083966116656,36,174,41,0.503804981708527,1.21904761904762,1.1906976744186,NA,215,210
"810",68,9.59,6,265,467,0.0133504859919954,1.7622641509434,1.7622641509434,0.787170054089145,38,180,39,0.476899385452271,1.21559633027523,1.21004566210046,NA,219,218
"811",68,11.11,7,284,505,0.0125665654705619,1.77816901408451,1.77816901408451,0.751259594341075,39,197,41,0.473541885614395,1.20338983050847,1.19327731092437,NA,238,236
"812",68,11.68,8,292,545,0.0128277550251848,1.86643835616438,1.86643835616438,0.725647188979379,41,209,38,0.449783682823181,1.168,1.18218623481781,NA,247,250
"813",68,14.92,9,309,587,0.0123355608792502,1.89967637540453,1.89967637540453,0.709735229009005,43,220,43,0.465755760669708,1.17490494296578,1.17490494296578,NA,263,263
"814",68,15.7,10,318,615,0.0122016546634129,1.93396226415094,1.93396226415094,0.701592485719956,40,237,36,0.465324878692627,1.14801444043321,1.16483516483516,NA,273,277
"815",68,17.92,11,329,675,0.0125101934909927,2.0516717325228,2.0516717325228,0.697716708394225,38,253,31,0.444883406162262,1.13058419243986,1.15845070422535,NA,284,291
"816",68,21.5,12,349,753,0.0123999604782136,2.15759312320917,2.15759312320917,0.712466623401042,36,281,28,0.4371297955513,1.10094637223975,1.1294498381877,NA,309,317
"817",69,2.89,1,163,202,0.015299553131864,1.23926380368098,1.23926380368098,0.85451323937861,33,87,36,0.651480197906494,1.35833333333333,1.32520325203252,NA,123,120
"818",69,5.11,2,224,340,0.013613068545804,1.51785714285714,1.51785714285714,0.776689576882428,32,137,45,0.565268218517303,1.32544378698225,1.23076923076923,NA,182,169
"819",69,6.63,3,252,395,0.0124897236451021,1.56746031746032,1.56746031746032,0.817217754548328,43,166,34,0.508549869060516,1.20574162679426,1.26,NA,200,209
"820",69,7.77,4,257,428,0.0130107003891051,1.66536964980545,1.66536964980545,0.795425992685575,45,168,36,0.493874937295914,1.20657276995305,1.25980392156863,NA,204,213
"821",69,11.25,5,271,467,0.0127647943146098,1.72324723247232,1.72324723247232,0.770699501734089,42,182,36,0.479797214269638,1.20982142857143,1.24311926605505,NA,218,224
"822",69,12.03,6,286,505,0.0123911176542755,1.76573426573427,1.76573426573427,0.777610902514224,44,199,37,0.464260339736938,1.17695473251029,1.21186440677966,NA,236,243
"823",69,12.73,7,298,538,0.0121573678620658,1.80536912751678,1.80536912751678,0.723495951666134,39,211,42,0.476371943950653,1.192,1.17786561264822,NA,253,250
"824",69,13.3,8,302,571,0.0125629799124332,1.89072847682119,1.89072847682119,0.705381967284272,43,216,39,0.449181258678436,1.16602316602317,1.1843137254902,NA,255,259
"825",69,14.55,9,315,613,0.0123951066626226,1.94603174603175,1.94603174603175,0.722121052633826,35,227,46,0.435073107481003,1.20229007633588,1.15384615384615,NA,273,262
"826",69,18.13,10,337,694,0.0122580189345768,2.0593471810089,2.0593471810089,0.736441098390471,43,262,28,0.429985493421555,1.10491803278689,1.16206896551724,NA,290,305
"827",69,18.26,11,340,716,0.012424084678119,2.10588235294118,2.10588235294118,0.682454104858947,39,257,40,0.42473316192627,1.14864864864865,1.14478114478114,NA,297,296
"828",69,21.5,12,349,753,0.0123999604782136,2.15759312320917,2.15759312320917,0.690467036456575,31,279,33,0.408374547958374,1.1258064516129,1.11858974358974,NA,312,310
"829",70,3.58,1,171,218,0.0149982800137599,1.27485380116959,1.27485380116959,0.924371348150703,34,82,37,0.5531205534935,1.47413793103448,1.43697478991597,NA,119,116
"830",70,3.71,2,202,281,0.0138416826757303,1.39108910891089,1.39108910891089,0.857647755956222,38,117,34,0.544294059276581,1.30322580645161,1.33774834437086,NA,151,155
"831",70,5.93,3,251,397,0.0126533864541833,1.58167330677291,1.58167330677291,0.764019902595994,35,159,46,0.498550236225128,1.29381443298969,1.22439024390244,NA,205,194
"832",70,7.07,4,259,431,0.0128999431325013,1.66409266409266,1.66409266409266,0.817758061462059,42,172,40,0.473401308059692,1.21028037383178,1.22169811320755,NA,212,214
"833",70,7.85,5,272,472,0.0128065986542218,1.73529411764706,1.73529411764706,0.748294249429302,35,180,49,0.488470911979675,1.26511627906977,1.18777292576419,NA,229,215
"834",70,9.37,6,285,515,0.0127254756609834,1.80701754385965,1.80701754385965,0.737496489868214,38,199,39,0.50844943523407,1.20253164556962,1.19747899159664,NA,238,237
"835",70,10.07,7,298,554,0.0125189252706031,1.85906040268456,1.85906040268456,0.739992892342733,34,225,31,0.471505224704742,1.15057915057915,1.1640625,NA,256,259
"836",70,13.55,8,307,590,0.012560941857742,1.92182410423453,1.92182410423453,0.696409957274764,37,222,42,0.443760395050049,1.18532818532819,1.16287878787879,NA,264,259
"837",70,16.79,9,320,630,0.0123432601880878,1.96875,1.96875,0.739242674654145,39,238,37,0.46714660525322,1.15523465703971,1.16363636363636,NA,275,277
"838",70,17.36,10,325,659,0.0125166191832858,2.02769230769231,2.02769230769231,0.696777179196132,39,244,36,0.425842940807343,1.14840989399293,1.16071428571429,NA,280,283
"839",70,20.25,11,339,717,0.0125150547206367,2.11504424778761,2.11504424778761,0.652887156981788,31,266,34,0.407088071107864,1.14141414141414,1.13,NA,300,297
"840",70,21.5,12,349,753,0.0123999604782136,2.15759312320917,2.15759312320917,0.738836924587832,40,266,39,0.386187851428986,1.14052287581699,1.14426229508197,NA,305,306
"841",71,0.7,1,144,151,0.0146658896658897,1.04861111111111,1.04861111111111,1.01081349627327,35,57,34,0.660585105419159,1.56521739130435,1.58241758241758,NA,91,92
"842",71,4.18,2,190,240,0.0133667502088555,1.26315789473684,1.26315789473684,0.975288060975447,38,95,43,0.584973990917206,1.42857142857143,1.3768115942029,NA,138,133
"843",71,5.43,3,216,311,0.0133936261843239,1.43981481481481,1.43981481481481,0.854203108441747,38,132,30,0.523603916168213,1.27058823529412,1.33333333333333,NA,162,170
"844",71,9.01,4,254,419,0.0130403660016806,1.6496062992126,1.6496062992126,0.824321232285737,43,167,35,0.492956876754761,1.20952380952381,1.25742574257426,NA,202,210
"845",71,9.58,5,270,466,0.0128321630180366,1.72592592592593,1.72592592592593,0.709808250220287,36,186,40,0.490753203630447,1.21621621621622,1.19469026548673,NA,226,222
"846",71,11.1,6,283,502,0.0125805077312483,1.77385159010601,1.77385159010601,0.708589863868357,39,199,38,0.490898936986923,1.1890756302521,1.19409282700422,NA,237,238
"847",71,12.24,7,288,535,0.0129452187379017,1.85763888888889,1.85763888888889,0.721224001542219,38,206,39,0.430650681257248,1.18032786885246,1.17551020408163,NA,245,244
"848",71,15.48,8,308,580,0.0122678624307289,1.88311688311688,1.88311688311688,0.729776244725405,36,227,36,0.425966054201126,1.17110266159696,1.17110266159696,NA,263,263
"849",71,17.7,9,325,644,0.0122317188983856,1.98153846153846,1.98153846153846,0.699167941450111,37,245,39,0.440255999565125,1.15248226950355,1.1443661971831,NA,284,282
"850",71,18.48,10,334,676,0.0121558684432936,2.02395209580838,2.02395209580838,0.711118354310158,43,255,30,0.426923930644989,1.12080536912752,1.1719298245614,NA,285,298
"851",71,21.37,11,346,731,0.0122476334087292,2.11271676300578,2.11271676300578,0.735306547015877,40,267,35,0.417555749416351,1.12703583061889,1.14569536423841,NA,302,307
"852",71,21.5,12,349,753,0.0123999604782136,2.15759312320917,2.15759312320917,0.65937071624081,37,278,33,0.404526203870773,1.10793650793651,1.12218649517685,NA,311,315
"853",72,1.14,1,114,141,0.0218910107126223,1.23684210526316,1.23684210526316,0.89543976713171,22,56,25,0.540893316268921,1.46153846153846,1.40740740740741,NA,81,78
"854",72,1.92,2,164,221,0.0165344904982792,1.34756097560976,1.34756097560976,0.803691269649609,26,92,34,0.576001703739166,1.38983050847458,1.3015873015873,NA,126,118
"855",72,2.62,3,198,281,0.0144080397887504,1.41919191919192,1.41919191919192,0.84633674430198,35,113,36,0.51184755563736,1.33783783783784,1.32885906040268,NA,149,148
"856",72,6.1,4,229,345,0.0132153527924615,1.50655021834061,1.50655021834061,0.81204302725319,39,139,44,0.53072464466095,1.28651685393258,1.25136612021858,NA,183,178
"857",72,8.99,5,260,425,0.0126225126225126,1.63461538461538,1.63461538461538,0.762435876748174,37,172,43,0.495775759220123,1.24401913875598,1.2093023255814,NA,215,209
"858",72,12.57,6,292,523,0.0123099373911406,1.79109589041096,1.79109589041096,0.767745706957012,41,203,36,0.462163060903549,1.19672131147541,1.22175732217573,NA,239,244
"859",72,13.82,7,306,565,0.0121075752705454,1.84640522875817,1.84640522875817,0.740247685159227,39,216,41,0.469281852245331,1.2,1.19066147859922,NA,257,255
"860",72,16.04,8,324,634,0.0121163475136643,1.95679012345679,1.95679012345679,0.735691508292215,44,240,34,0.479869693517685,1.14084507042254,1.18248175182482,NA,274,284
"861",72,17.56,9,334,668,0.012012012012012,2,2,0.704980139434436,38,251,39,0.450346738100052,1.15570934256055,1.15172413793103,NA,290,289
"862",72,17.69,10,337,690,0.0121873675286138,2.04747774480712,2.04747774480712,0.725421961712134,40,256,36,0.434341579675674,1.13851351351351,1.1541095890411,NA,292,296
"863",72,18.26,11,340,716,0.012424084678119,2.10588235294118,2.10588235294118,0.7045150002722,38,255,45,0.421300023794174,1.16040955631399,1.13333333333333,NA,300,293
"864",72,21.5,12,349,753,0.0123999604782136,2.15759312320917,2.15759312320917,0.733806957235921,46,270,30,0.387392461299896,1.10443037974684,1.16333333333333,NA,300,316
"865",73,2.22,1,171,214,0.0147230822153423,1.25146198830409,1.25146198830409,0.909397688880267,35,83,39,0.590553760528564,1.44915254237288,1.40163934426229,NA,122,118
"866",73,5.8,2,237,355,0.0126939855538869,1.49789029535865,1.49789029535865,0.776477234064307,39,142,46,0.531017601490021,1.30939226519337,1.26063829787234,NA,188,181
"867",73,7.32,3,255,401,0.0123822757449436,1.57254901960784,1.57254901960784,0.81616667475646,42,163,39,0.500450849533081,1.24390243902439,1.26237623762376,NA,202,205
"868",73,8.02,4,273,447,0.0120394311570782,1.63736263736264,1.63736263736264,0.823979967074442,42,169,41,0.461758524179459,1.29383886255924,1.3,NA,210,211
"869",73,9.27,5,292,507,0.0119333427481994,1.73630136986301,1.73630136986301,0.789407103693491,47,181,48,0.485551387071609,1.28070175438597,1.27510917030568,NA,229,228
"870",73,9.4,6,297,538,0.0122395122395122,1.81144781144781,1.81144781144781,0.761644957302335,48,200,45,0.461080551147461,1.19758064516129,1.21224489795918,NA,245,248
"871",73,12.88,7,307,575,0.0122415958783079,1.87296416938111,1.87296416938111,0.710604134981777,37,214,45,0.465468466281891,1.22310756972112,1.18532818532819,NA,259,251
"872",73,16.12,8,320,619,0.0121277429467085,1.934375,1.934375,0.700442731787706,41,236,40,0.448367655277252,1.15523465703971,1.15942028985507,NA,276,277
"873",73,19.01,9,334,680,0.0122277966589344,2.03592814371257,2.03592814371257,0.671058006628357,35,252,44,0.436546266078949,1.16376306620209,1.12837837837838,NA,296,287
"874",73,19.79,10,343,708,0.0120709938110583,2.06413994169096,2.06413994169096,0.668191799042403,39,251,44,0.414518117904663,1.18275862068966,1.16271186440678,NA,295,290
"875",73,20.93,11,346,727,0.0121806148948647,2.10115606936416,2.10115606936416,0.658997522484033,32,282,28,0.414896786212921,1.10191082802548,1.11612903225806,NA,310,314
"876",73,21.5,12,349,753,0.0123999604782136,2.15759312320917,2.15759312320917,0.63261528995534,27,281,37,0.408594876527786,1.13311688311688,1.09748427672956,NA,318,308
"877",74,0.7,1,144,151,0.0146658896658897,1.04861111111111,1.04861111111111,0.959160619417373,34,59,32,0.590829312801361,1.54838709677419,1.58241758241758,NA,91,93
"878",74,3.94,2,199,243,0.0123343992690726,1.22110552763819,1.22110552763819,0.928031949277522,39,103,37,0.598316669464111,1.40140845070423,1.42142857142857,NA,140,142
"879",74,5.19,3,227,326,0.0127090561771471,1.43612334801762,1.43612334801762,0.788535140566949,34,143,39,0.541138231754303,1.28248587570621,1.24725274725275,NA,182,177
"880",74,8.77,4,268,437,0.0122142098496283,1.63059701492537,1.63059701492537,0.782270914096993,42,172,43,0.486126035451889,1.25233644859813,1.24651162790698,NA,215,214
"881",74,8.9,5,274,474,0.0126734579289324,1.72992700729927,1.72992700729927,0.68559045874084,31,188,49,0.48042294383049,1.25114155251142,1.15611814345992,NA,237,219
"882",74,10.04,6,280,503,0.0128776241679467,1.79642857142857,1.79642857142857,0.766793544923627,40,200,32,0.451768487691879,1.16666666666667,1.20689655172414,NA,232,240
"883",74,10.61,7,291,542,0.0128451238298377,1.86254295532646,1.86254295532646,0.716523747751388,39,214,32,0.457137405872345,1.1501976284585,1.18292682926829,NA,246,253
"884",74,12.13,8,302,576,0.0126729884931025,1.90728476821192,1.90728476821192,0.737406694595235,41,216,40,0.459765017032623,1.17509727626459,1.1796875,NA,256,257
"885",74,15.61,9,312,609,0.0125525599802127,1.95192307692308,1.95192307692308,0.747614211946103,44,223,36,0.442675679922104,1.1685393258427,1.2046332046332,NA,259,267
"886",74,17.83,10,329,670,0.0124175253910594,2.03647416413374,2.03647416413374,0.718153527624336,42,245,39,0.417550712823868,1.14634146341463,1.15845070422535,NA,284,287
"887",74,18.61,11,337,699,0.0123463331920305,2.07418397626113,2.07418397626113,0.687447696052438,42,255,37,0.42359921336174,1.13468013468013,1.1541095890411,NA,292,297
"888",74,21.5,12,349,753,0.0123999604782136,2.15759312320917,2.15759312320917,0.633590296269106,31,272,41,0.432338804006577,1.15181518151815,1.11501597444089,NA,313,303
"889",75,3.48,1,144,158,0.0153457653457653,1.09722222222222,1.09722222222222,1.00139796040035,35,61,31,0.6043301820755,1.5,1.56521739130435,NA,92,96
"890",75,4.05,2,185,240,0.0141010575793184,1.2972972972973,1.2972972972973,0.832560216555428,33,97,42,0.562447905540466,1.42307692307692,1.33093525179856,NA,139,130
"891",75,5.3,3,216,318,0.0136950904392765,1.47222222222222,1.47222222222222,0.810120851121286,36,136,35,0.50903844833374,1.25581395348837,1.26315789473684,NA,171,172
"892",75,8.88,4,258,425,0.0128193526980967,1.64728682170543,1.64728682170543,0.756306652268306,43,169,40,0.514206230640411,1.21698113207547,1.23444976076555,NA,209,212
"893",75,9.58,5,270,466,0.0128321630180366,1.72592592592593,1.72592592592593,0.740779721989323,37,192,34,0.503179728984833,1.17903930131004,1.19469026548673,NA,226,229
"894",75,11.1,6,283,502,0.0125805077312483,1.77385159010601,1.77385159010601,0.71334527196748,45,193,41,0.481672883033752,1.1890756302521,1.20940170940171,NA,234,238
"895",75,11.88,7,297,541,0.0123077623077623,1.82154882154882,1.82154882154882,0.738431360079957,43,207,41,0.482438236474991,1.188,1.19758064516129,NA,248,250
"896",75,14.77,8,317,606,0.0120991893942419,1.91167192429022,1.91167192429022,0.751119857646219,39,238,28,0.437752515077591,1.14440433212996,1.19172932330827,NA,266,277
"897",75,16.99,9,333,674,0.0121929158073736,2.02402402402402,2.02402402402402,0.706982020524115,37,254,35,0.435615181922913,1.14432989690722,1.1522491349481,NA,289,291
"898",75,20.23,10,343,713,0.0121562409424923,2.07871720116618,2.07871720116618,0.653375838717991,29,279,27,0.429629862308502,1.11363636363636,1.12091503267974,NA,306,308
"899",75,21.37,11,346,731,0.0122476334087292,2.11271676300578,2.11271676300578,0.629693214233536,32,276,35,0.428281605243683,1.12337662337662,1.11254019292605,NA,311,308
"900",75,21.5,12,349,753,0.0123999604782136,2.15759312320917,2.15759312320917,0.647086147048207,33,275,37,0.43785896897316,1.13311688311688,1.11858974358974,NA,312,308
"901",76,0.7,1,144,151,0.0146658896658897,1.04861111111111,1.04861111111111,0.998150898735472,45,51,38,0.640322744846344,1.5,1.61797752808989,NA,89,96
"902",76,1.27,2,184,236,0.0140175813732478,1.28260869565217,1.28260869565217,0.913650878989133,41,99,32,0.564160823822021,1.31428571428571,1.40458015267176,NA,131,140
"903",76,4.85,3,239,358,0.0125874617629479,1.4979079497908,1.4979079497908,0.829854816175671,44,146,39,0.525049984455109,1.25789473684211,1.29189189189189,NA,185,190
"904",76,8.09,4,267,417,0.0117428402466841,1.56179775280899,1.56179775280899,0.798533373589831,41,164,51,0.517534136772156,1.30243902439024,1.24186046511628,NA,215,205
"905",76,11.57,5,279,462,0.0119130502049973,1.65591397849462,1.65591397849462,0.802539300460666,58,172,44,0.482084304094315,1.21304347826087,1.29166666666667,NA,216,230
"906",76,14.46,6,303,541,0.0118243612440714,1.78547854785479,1.78547854785479,0.760661369960608,46,205,45,0.473091840744019,1.20717131474104,1.212,NA,250,251
"907",76,16.68,7,317,611,0.0121990176895739,1.92744479495268,1.92744479495268,0.747145083888139,39,238,33,0.4422427713871,1.14440433212996,1.16974169741697,NA,271,277
"908",76,17.82,8,320,631,0.0123628526645768,1.971875,1.971875,0.775911135087295,41,241,29,0.448604971170425,1.13475177304965,1.18518518518519,NA,270,282
"909",76,17.95,9,324,658,0.012575010511027,2.03086419753086,2.03086419753086,0.742120720000125,42,242,33,0.439903795719147,1.14084507042254,1.17818181818182,NA,275,284
"910",76,19.47,10,332,689,0.0125395843191497,2.07530120481928,2.07530120481928,0.716140847049198,40,247,40,0.449162781238556,1.15679442508711,1.15679442508711,NA,287,287
"911",76,20.72,11,342,727,0.0124676304642349,2.12573099415205,2.12573099415205,0.632064708672077,32,270,34,0.412950873374939,1.13245033112583,1.125,NA,304,302
"912",76,21.5,12,349,753,0.0123999604782136,2.15759312320917,2.15759312320917,0.641336987125433,29,280,36,0.404100298881531,1.1294498381877,1.10443037974684,NA,316,309
"913",77,0.78,1,137,147,0.0157793044224989,1.07299270072993,1.07299270072993,1.00220559374568,27,67,23,0.614257991313934,1.45744680851064,1.52222222222222,NA,90,94
"914",77,2.03,2,187,247,0.0142027485480996,1.32085561497326,1.32085561497326,0.871998193722453,42,98,39,0.603665053844452,1.33571428571429,1.36496350364964,NA,137,140
"915",77,2.16,3,204,291,0.0140538974210374,1.42647058823529,1.42647058823529,0.854906463345445,38,117,33,0.507197618484497,1.31612903225806,1.36,NA,150,155
"916",77,2.86,4,225,346,0.0137301587301587,1.53777777777778,1.53777777777778,0.817410884673962,40,135,41,0.519796848297119,1.28571428571429,1.27840909090909,NA,176,175
"917",77,6.34,5,247,396,0.013034462328429,1.60323886639676,1.60323886639676,0.829540212530759,40,157,39,0.50218403339386,1.25380710659898,1.26020408163265,NA,196,197
"918",77,9.23,6,274,468,0.0125130344108446,1.70802919708029,1.70802919708029,0.773605757492386,41,181,44,0.495272248983383,1.23423423423423,1.21777777777778,NA,225,222
"919",77,10.37,7,282,500,0.0126195704298226,1.77304964539007,1.77304964539007,0.753443454511291,45,191,41,0.474301993846893,1.19491525423729,1.21551724137931,NA,232,236
"920",77,13.61,8,300,547,0.0121962095875139,1.82333333333333,1.82333333333333,0.655897237958204,31,223,37,0.456450164318085,1.18110236220472,1.15384615384615,NA,260,254
"921",77,15.83,9,313,611,0.0125133120340788,1.95207667731629,1.95207667731629,0.714106297825729,30,247,31,0.43519914150238,1.12996389891697,1.12589928057554,NA,278,277
"922",77,16.4,10,317,641,0.0127979874615661,2.02208201892744,2.02208201892744,0.651752515346556,27,249,38,0.453972071409225,1.14855072463768,1.10452961672474,NA,287,276
"923",77,19.98,11,341,722,0.0124547179575643,2.11730205278592,2.11730205278592,0.657690954091339,32,267,37,0.423487037420273,1.14046822742475,1.12171052631579,NA,304,299
"924",77,21.5,12,349,753,0.0123999604782136,2.15759312320917,2.15759312320917,0.683277587005728,33,273,40,0.399202674627304,1.14052287581699,1.11501597444089,NA,313,306
"925",78,1.52,1,120,123,0.0172268907563025,1.025,1.025,0.958760007485382,26,48,32,0.609458744525909,1.62162162162162,1.5,NA,80,74
"926",78,3.74,2,207,278,0.013038788049341,1.34299516908213,1.34299516908213,0.872196607256941,40,116,40,0.598325610160828,1.32692307692308,1.32692307692308,NA,156,156
"927",78,7.32,3,255,401,0.0123822757449436,1.57254901960784,1.57254901960784,0.794419816302537,43,166,38,0.520596861839294,1.2200956937799,1.25,NA,204,209
"928",78,10.8,4,271,448,0.0122454557878912,1.65313653136531,1.65313653136531,0.705628181550363,37,178,47,0.510998845100403,1.26046511627907,1.20444444444444,NA,225,215
"929",78,11.94,5,277,483,0.0126353790613718,1.74368231046931,1.74368231046931,0.745837460882321,40,194,36,0.515240728855133,1.18376068376068,1.20434782608696,NA,230,234
"930",78,14.83,6,300,559,0.012463768115942,1.86333333333333,1.86333333333333,0.701863728459215,38,219,38,0.429998964071274,1.16731517509728,1.16731517509728,NA,257,257
"931",78,15.4,7,306,592,0.0126861673631201,1.93464052287582,1.93464052287582,0.740929960286158,39,219,46,0.440330535173416,1.18604651162791,1.15471698113208,NA,265,258
"932",78,16.1,8,316,625,0.0125577657223227,1.97784810126582,1.97784810126582,0.731212142582655,40,231,42,0.445879012346268,1.16605166051661,1.15750915750916,NA,273,271
"933",78,16.23,9,320,652,0.0127742946708464,2.0375,2.0375,0.652338886718201,30,256,30,0.460954308509827,1.11888111888112,1.11888111888112,NA,286,286
"934",78,17.48,10,332,690,0.0125577840061151,2.07831325301205,2.07831325301205,0.680443601285978,33,263,33,0.442772537469864,1.12162162162162,1.12162162162162,NA,296,296
"935",78,20.72,11,342,727,0.0124676304642349,2.12573099415205,2.12573099415205,0.70303369320652,30,258,46,0.416958212852478,1.1875,1.125,NA,304,288
"936",78,21.5,12,349,753,0.0123999604782136,2.15759312320917,2.15759312320917,0.694922672416577,35,278,32,0.428599923849106,1.11501597444089,1.1258064516129,NA,310,313
"937",79,2.89,1,163,202,0.015299553131864,1.23926380368098,1.23926380368098,0.886828048402195,36,87,33,0.606288611888885,1.32520325203252,1.35833333333333,NA,120,123
"938",79,4.03,2,189,274,0.0154227175503771,1.44973544973545,1.44973544973545,0.818594352133376,37,116,29,0.521784603595734,1.23529411764706,1.30344827586207,NA,145,153
"939",79,4.81,3,216,332,0.0142980189491817,1.53703703703704,1.53703703703704,0.829748648037027,43,131,36,0.55236154794693,1.24137931034483,1.29341317365269,NA,167,174
"940",79,8.05,4,251,391,0.0124621513944223,1.55776892430279,1.55776892430279,0.739671126760298,37,158,45,0.494590520858765,1.28717948717949,1.23645320197044,NA,203,195
"941",79,9.3,5,271,443,0.0121087877545442,1.63468634686347,1.63468634686347,0.809539431973442,45,169,48,0.48748779296875,1.26635514018692,1.24884792626728,NA,217,214
"942",79,9.43,6,277,473,0.0123737770104118,1.70758122743682,1.70758122743682,0.753826452932452,45,183,44,0.478746592998505,1.21491228070175,1.22026431718062,NA,227,228
"943",79,13.01,7,307,569,0.0121138574865342,1.85342019543974,1.85342019543974,0.7143505160401,33,230,36,0.471593230962753,1.16730038022814,1.15413533834586,NA,266,263
"944",79,16.49,8,319,603,0.0118885668657952,1.89028213166144,1.89028213166144,0.721293942733763,34,242,36,0.451651334762573,1.15579710144928,1.14748201438849,NA,278,276
"945",79,17.19,9,325,634,0.0120417853751187,1.95076923076923,1.95076923076923,0.675861435427785,36,244,41,0.434443056583405,1.16071428571429,1.14035087719298,NA,285,280
"946",79,17.76,10,329,664,0.0123063236711394,2.01823708206687,2.01823708206687,0.713362717299218,40,242,41,0.430304408073425,1.16666666666667,1.16254416961131,NA,283,282
"947",79,19.28,11,338,695,0.0122030446157358,2.05621301775148,2.05621301775148,0.702881778404705,41,259,34,0.424901366233826,1.12666666666667,1.15358361774744,NA,293,300
"948",79,21.5,12,349,753,0.0123999604782136,2.15759312320917,2.15759312320917,0.646131506166198,27,281,39,0.416804641485214,1.13311688311688,1.090625,NA,320,308
"949",80,0.13,1,110,118,0.0196830692243536,1.07272727272727,1.07272727272727,1.00788998709275,28,50,21,0.625394999980927,1.41025641025641,1.54929577464789,NA,71,78
"950",80,2.35,2,195,268,0.0141686492201956,1.37435897435897,1.37435897435897,0.861035838740607,38,103,39,0.558873057365417,1.38297872340426,1.37323943661972,NA,142,141
"951",80,3.6,3,230,347,0.0131763812416936,1.50869565217391,1.50869565217391,0.792637729171539,41,142,39,0.522340536117554,1.2568306010929,1.2707182320442,NA,181,183
"952",80,4.3,4,241,394,0.0136237897648686,1.63485477178423,1.63485477178423,0.791510154895406,40,157,35,0.473743289709091,1.22335025380711,1.25520833333333,NA,192,197
"953",80,4.87,5,256,438,0.0134191176470588,1.7109375,1.7109375,0.768285490487943,39,177,31,0.508079469203949,1.18518518518519,1.23076923076923,NA,208,216
"954",80,8.35,6,273,481,0.0129551820728291,1.76190476190476,1.76190476190476,0.723119682601922,37,182,43,0.460189938545227,1.24657534246575,1.21333333333333,NA,225,219
"955",80,9.13,7,285,513,0.0126760563380282,1.8,1.8,0.712862182852034,33,210,34,0.462111860513687,1.17283950617284,1.16803278688525,NA,244,243
"956",80,12.02,8,301,579,0.0128239202657807,1.92358803986711,1.92358803986711,0.69438864413494,32,226,36,0.430904895067215,1.16666666666667,1.14885496183206,NA,262,258
"957",80,15.26,9,314,622,0.0126574550782442,1.98089171974522,1.98089171974522,0.727420386348331,38,230,36,0.431706994771957,1.17164179104478,1.18045112781955,NA,266,268
"958",80,16.78,10,326,656,0.0123831996224634,2.01226993865031,2.01226993865031,0.677443225078716,40,244,39,0.462475836277008,1.14788732394366,1.15194346289753,NA,283,284
"959",80,20.36,11,346,735,0.0123146519225936,2.1242774566474,2.1242774566474,0.718479409816343,40,263,36,0.406905442476273,1.14191419141914,1.15719063545151,NA,299,303
"960",80,21.5,12,349,753,0.0123999604782136,2.15759312320917,2.15759312320917,0.733806957235921,34,274,36,0.383582949638367,1.13311688311688,1.1258064516129,NA,310,308
"961",81,0.78,1,137,147,0.0157793044224989,1.07299270072993,1.07299270072993,0.976382868690995,30,58,32,0.627053558826447,1.55681818181818,1.52222222222222,NA,90,88
"962",81,1.48,2,185,226,0.0132784958871915,1.22162162162162,1.22162162162162,0.870153229839012,36,85,46,0.595220863819122,1.52892561983471,1.41221374045802,NA,131,121
"963",81,4.96,3,219,297,0.0124418750785472,1.35616438356164,1.35616438356164,0.856633211072914,41,118,43,0.57182377576828,1.37735849056604,1.36024844720497,NA,161,159
"964",81,6.48,4,244,343,0.0115698576536464,1.40573770491803,1.40573770491803,0.847415355586566,37,147,38,0.5508673787117,1.32608695652174,1.31891891891892,NA,185,184
"965",81,9.72,5,270,402,0.0110698058653449,1.48888888888889,1.48888888888889,0.801909540178393,43,164,48,0.506008505821228,1.30434782608696,1.27358490566038,NA,212,207
"966",81,9.85,6,276,439,0.0115678524374177,1.59057971014493,1.59057971014493,0.886475739781105,45,174,41,0.490001142024994,1.26027397260274,1.28372093023256,NA,215,219
"967",81,12.07,7,293,515,0.0120388984992286,1.75767918088737,1.75767918088737,0.74283836838819,38,203,43,0.466300308704376,1.21576763485477,1.19105691056911,NA,246,241
"968",81,15.65,8,317,607,0.0121191550533083,1.91482649842271,1.91482649842271,0.709168858695315,36,235,40,0.455342531204224,1.16974169741697,1.15272727272727,NA,275,271
"969",81,16.22,9,322,637,0.0123256128944873,1.97826086956522,1.97826086956522,0.747987906286276,37,243,38,0.394484281539917,1.15,1.14590747330961,NA,281,280
"970",81,17.47,10,334,679,0.0122098146050242,2.03293413173653,2.03293413173653,0.697027662001807,32,256,38,0.406059294939041,1.15972222222222,1.13605442176871,NA,294,288
"971",81,18.61,11,337,699,0.0123463331920305,2.07418397626113,2.07418397626113,0.695451485144831,34,259,34,0.413483619689941,1.15017064846416,1.15017064846416,NA,293,293
"972",81,21.5,12,349,753,0.0123999604782136,2.15759312320917,2.15759312320917,0.678745510997236,36,266,42,0.436544179916382,1.15562913907285,1.13311688311688,NA,308,302
"973",82,3.58,1,171,218,0.0149982800137599,1.27485380116959,1.27485380116959,0.943745657874571,38,91,30,0.600738644599915,1.32558139534884,1.41322314049587,NA,121,129
"974",82,4.72,2,198,293,0.0150233297441419,1.47979797979798,1.47979797979798,0.813403511497777,34,118,34,0.542027294635773,1.30263157894737,1.30263157894737,NA,152,152
"975",82,5.97,3,228,369,0.0142592163227452,1.61842105263158,1.61842105263158,0.807608587311664,36,149,36,0.495049923658371,1.23243243243243,1.23243243243243,NA,185,185
"976",82,6.67,4,247,417,0.0137256838155426,1.68825910931174,1.68825910931174,0.821338264963188,40,153,43,0.476832926273346,1.27979274611399,1.26020408163265,NA,196,193
"977",82,7.45,5,269,461,0.0127892137823892,1.71375464684015,1.71375464684015,0.684657035518346,35,181,49,0.5040442943573,1.24537037037037,1.1695652173913,NA,230,216
"978",82,10.69,6,289,509,0.0122308727412534,1.76124567474048,1.76124567474048,0.783578310680801,46,188,48,0.467928916215897,1.23504273504274,1.22457627118644,NA,236,234
"979",82,10.82,7,293,537,0.0125531815419141,1.83276450511945,1.83276450511945,0.637650136685558,28,209,47,0.496879041194916,1.23628691983122,1.14453125,NA,256,237
"980",82,13.71,8,313,600,0.0122880314573605,1.91693290734824,1.91693290734824,0.719698516335802,41,221,47,0.447461128234863,1.19465648854962,1.16791044776119,NA,268,262
"981",82,14.28,9,319,632,0.0124603221545317,1.98119122257053,1.98119122257053,0.730399321325645,36,230,44,0.429856449365616,1.19924812030075,1.16423357664234,NA,274,266
"982",82,16.5,10,332,690,0.0125577840061151,2.07831325301205,2.07831325301205,0.750814720675976,43,249,35,0.430133402347565,1.13698630136986,1.16901408450704,NA,284,292
"983",82,19.98,11,341,722,0.0124547179575643,2.11730205278592,2.11730205278592,0.740288532490135,48,256,32,0.436779201030731,1.12171052631579,1.18402777777778,NA,288,304
"984",82,21.5,12,349,753,0.0123999604782136,2.15759312320917,2.15759312320917,0.688676710475196,41,262,43,0.434152692556381,1.15181518151815,1.14426229508197,NA,305,303
"985",83,1.14,1,114,141,0.0218910107126223,1.23684210526316,1.23684210526316,0.901876987941988,23,61,20,0.574719548225403,1.35714285714286,1.40740740740741,NA,81,84
"986",83,2.66,2,164,215,0.0160855903037558,1.3109756097561,1.3109756097561,0.892484202646212,33,88,31,0.582217454910278,1.35537190082645,1.3781512605042,NA,119,121
"987",83,5.9,3,210,289,0.0131692868534974,1.37619047619048,1.37619047619048,0.886797749286909,39,119,33,0.513589382171631,1.32911392405063,1.38157894736842,NA,152,158
"988",83,6.6,4,238,342,0.0121263695351558,1.43697478991597,1.43697478991597,0.865458062113727,38,143,38,0.54458212852478,1.31491712707182,1.31491712707182,NA,181,181
"989",83,8.82,5,261,425,0.0125257883878574,1.62835249042146,1.62835249042146,0.733538145796682,38,170,47,0.492016643285751,1.25480769230769,1.20276497695853,NA,217,208
"990",83,8.95,6,269,460,0.0127614714531432,1.71003717472119,1.71003717472119,0.770605779565615,42,182,38,0.461651712656021,1.20089285714286,1.22272727272727,NA,220,224
"991",83,12.53,7,300,557,0.0124191750278707,1.85666666666667,1.85666666666667,0.74027299395652,46,206,44,0.461248874664307,1.19047619047619,1.2,NA,250,252
"992",83,13.31,8,311,594,0.0123223731978011,1.90996784565916,1.90996784565916,0.73171620853323,40,228,39,0.463943600654602,1.16044776119403,1.16479400749064,NA,267,268
"993",83,14.56,9,324,638,0.0121927913465581,1.96913580246914,1.96913580246914,0.695422533628843,43,233,45,0.440449893474579,1.17391304347826,1.16546762589928,NA,278,276
"994",83,15.13,10,328,666,0.0124188856567465,2.03048780487805,2.03048780487805,0.752637315179637,41,239,40,0.428810566663742,1.17142857142857,1.17562724014337,NA,279,280
"995",83,18.02,11,340,723,0.0125455491931286,2.12647058823529,2.12647058823529,0.676509230416512,30,261,46,0.383828908205032,1.16838487972509,1.10749185667752,NA,307,291
"996",83,21.5,12,349,753,0.0123999604782136,2.15759312320917,2.15759312320917,0.66774303995307,32,275,36,0.426255166530609,1.13680781758958,1.12218649517685,NA,311,307
"997",84,0.13,1,110,118,0.0196830692243536,1.07272727272727,1.07272727272727,0.942487203732444,20,44,30,0.580508530139923,1.71875,1.48648648648649,NA,74,64
"998",84,0.91,2,167,203,0.0146454079792223,1.21556886227545,1.21556886227545,0.808260226436501,28,86,41,0.58854866027832,1.46491228070175,1.31496062992126,NA,127,114
"999",84,4.39,3,198,273,0.0139978464851561,1.37878787878788,1.37878787878788,0.781265969287375,32,118,34,0.555763483047485,1.32,1.30263157894737,NA,152,150
"1000",84,5.53,4,211,325,0.0146693748589483,1.54028436018957,1.54028436018957,0.766097001289403,36,126,38,0.532421290874481,1.30246913580247,1.28658536585366,NA,164,162
"1001",84,8.42,5,248,414,0.0135170432284184,1.66935483870968,1.66935483870968,0.732064918290367,31,174,40,0.508979260921478,1.20975609756098,1.1588785046729,NA,214,205
"1002",84,9.94,6,268,454,0.0126893621778747,1.69402985074627,1.69402985074627,0.797164329485645,49,169,42,0.474162608385086,1.22935779816514,1.27014218009479,NA,211,218
"1003",84,10.64,7,284,493,0.0122679540138357,1.73591549295775,1.73591549295775,0.774231671979014,37,193,39,0.489380717277527,1.23478260869565,1.22413793103448,NA,232,230
"1004",84,14.22,8,308,584,0.012352468378527,1.8961038961039,1.8961038961039,0.751103022444752,44,219,34,0.433191359043121,1.17110266159696,1.21739130434783,NA,253,263
"1005",84,15.47,9,322,624,0.0120740697741917,1.93788819875776,1.93788819875776,0.710625884179142,44,232,40,0.423337548971176,1.16666666666667,1.18382352941176,NA,272,276
"1006",84,17.69,10,337,690,0.0121873675286138,2.04747774480712,2.04747774480712,0.657666170796796,36,250,43,0.429801493883133,1.17832167832168,1.15017064846416,NA,293,286
"1007",84,18.26,11,340,716,0.012424084678119,2.10588235294118,2.10588235294118,0.665678491864337,26,270,36,0.438714236021042,1.14864864864865,1.11111111111111,NA,306,296
"1008",84,21.5,12,349,753,0.0123999604782136,2.15759312320917,2.15759312320917,0.710731716316568,41,272,32,0.406281054019928,1.11501597444089,1.14802631578947,NA,304,313
"1009",85,0.13,1,110,118,0.0196830692243536,1.07272727272727,1.07272727272727,0.916759015700688,28,50,22,0.673836588859558,1.41025641025641,1.52777777777778,NA,72,78
"1010",85,2.35,2,195,268,0.0141686492201956,1.37435897435897,1.37435897435897,0.901296730069133,39,106,40,0.559687554836273,1.3448275862069,1.33561643835616,NA,146,145
"1011",85,3.05,3,219,329,0.0137824138075489,1.50228310502283,1.50228310502283,0.766090555053207,31,140,34,0.558180332183838,1.28070175438596,1.25862068965517,NA,174,171
"1012",85,6.53,4,242,385,0.013202565069785,1.59090909090909,1.59090909090909,0.808277106423846,39,159,37,0.521966576576233,1.22222222222222,1.23469387755102,NA,196,198
"1013",85,7.78,5,262,442,0.0129273785499108,1.68702290076336,1.68702290076336,0.746852843480252,34,182,36,0.489207327365875,1.21296296296296,1.20183486238532,NA,218,216
"1014",85,10.67,6,284,514,0.0127905240631066,1.80985915492958,1.80985915492958,0.770083233859788,45,198,31,0.442567259073257,1.16872427983539,1.24017467248908,NA,229,243
"1015",85,13.91,7,298,560,0.0126545092988046,1.87919463087248,1.87919463087248,0.77111797409999,45,202,48,0.441717177629471,1.20647773279352,1.192,NA,250,247
"1016",85,14.48,8,306,595,0.0127504553734062,1.94444444444444,1.94444444444444,0.711674853677559,39,223,38,0.455661326646805,1.16793893129771,1.17241379310345,NA,261,262
"1017",85,15.62,9,309,614,0.0129029546505275,1.98705501618123,1.98705501618123,0.709368808016039,38,219,45,0.422487288713455,1.20233463035019,1.17045454545455,NA,264,257
"1018",85,17.14,10,321,648,0.0126168224299065,2.01869158878505,2.01869158878505,0.722060649365034,36,248,27,0.439451575279236,1.13028169014085,1.16727272727273,NA,275,284
"1019",85,17.92,11,329,675,0.0125101934909927,2.0516717325228,2.0516717325228,0.705972513347032,39,246,38,0.427420556545258,1.15438596491228,1.15845070422535,NA,284,285
"1020",85,21.5,12,349,753,0.0123999604782136,2.15759312320917,2.15759312320917,0.642298754082726,35,273,36,0.41052782535553,1.13311688311688,1.1294498381877,NA,309,308
"1021",86,0.78,1,137,147,0.0157793044224989,1.07299270072993,1.07299270072993,0.915622890760177,28,62,30,0.628071665763855,1.52222222222222,1.48913043478261,NA,92,90
"1022",86,2.03,2,187,247,0.0142027485480996,1.32085561497326,1.32085561497326,0.916789216630732,40,105,33,0.565982103347778,1.28965517241379,1.35507246376812,NA,138,145
"1023",86,5.51,3,218,310,0.0131061598951507,1.42201834862385,1.42201834862385,0.791897327747207,36,132,41,0.574974060058594,1.29761904761905,1.26011560693642,NA,173,168
"1024",86,8.4,4,254,396,0.0123245463882232,1.55905511811024,1.55905511811024,0.792897695650481,40,158,44,0.508194327354431,1.28282828282828,1.25742574257426,NA,202,198
"1025",86,8.97,5,268,448,0.0125216613561406,1.67164179104478,1.67164179104478,0.763656276614658,38,183,42,0.463167160749435,1.21266968325792,1.19111111111111,NA,225,221
"1026",86,12.21,6,289,498,0.0119665513264129,1.72318339100346,1.72318339100346,0.756843147312905,34,205,35,0.464821130037308,1.2092050209205,1.20416666666667,NA,240,239
"1027",86,12.91,7,298,531,0.0119991864958308,1.78187919463087,1.78187919463087,0.761494141484839,42,212,34,0.473870515823364,1.17322834645669,1.21138211382114,NA,246,254
"1028",86,13.04,8,301,559,0.0123809523809524,1.85714285714286,1.85714285714286,0.705403209776451,39,213,46,0.484819829463959,1.19444444444444,1.16216216216216,NA,259,252
"1029",86,14.18,9,304,581,0.0126150772972034,1.91118421052632,1.91118421052632,0.689790769016523,32,231,30,0.44937801361084,1.15589353612167,1.16475095785441,NA,261,263
"1030",86,15.7,10,318,615,0.0122016546634129,1.93396226415094,1.93396226415094,0.713512753264955,44,234,37,0.452643305063248,1.14388489208633,1.17343173431734,NA,271,278
"1031",86,17.92,11,329,675,0.0125101934909927,2.0516717325228,2.0516717325228,0.669101735705725,42,247,37,0.400661736726761,1.13840830449827,1.15845070422535,NA,284,289
"1032",86,21.5,12,349,753,0.0123999604782136,2.15759312320917,2.15759312320917,0.645175452740962,36,273,38,0.417101830244064,1.1294498381877,1.12218649517685,NA,311,309
"1033",87,0.7,1,144,151,0.0146658896658897,1.04861111111111,1.04861111111111,0.952507081359626,32,64,30,0.607648730278015,1.5,1.53191489361702,NA,94,96
"1034",87,3.59,2,200,282,0.0141708542713568,1.41,1.41,0.850796493883108,41,114,33,0.556995391845703,1.29032258064516,1.36054421768707,NA,147,155
"1035",87,3.72,3,217,329,0.0140382317801673,1.51612903225806,1.51612903225806,0.856452111409155,30,137,38,0.505030453205109,1.29940119760479,1.24,NA,175,167
"1036",87,4.86,4,228,372,0.014375144910735,1.63157894736842,1.63157894736842,0.772972842754676,33,147,40,0.52179080247879,1.26666666666667,1.2192513368984,NA,187,180
"1037",87,6.38,5,256,419,0.0128370098039216,1.63671875,1.63671875,0.785249531321218,42,162,43,0.477967739105225,1.25490196078431,1.24878048780488,NA,205,204
"1038",87,8.6,6,278,497,0.0129080850842791,1.78776978417266,1.78776978417266,0.779888781503135,42,189,42,0.456799119710922,1.2034632034632,1.2034632034632,NA,231,231
"1039",87,9.85,7,293,545,0.0127401935574361,1.86006825938567,1.86006825938567,0.745354402635536,41,213,34,0.480121195316315,1.15354330708661,1.18623481781377,NA,247,254
"1040",87,10.63,8,304,574,0.0124630884141046,1.88815789473684,1.88815789473684,0.703220057077584,37,219,42,0.446952223777771,1.1875,1.16475095785441,NA,261,256
"1041",87,11.2,9,307,605,0.0128802878371761,1.97068403908795,1.97068403908795,0.726214076059338,33,238,27,0.431779265403748,1.13284132841328,1.15849056603774,NA,265,271
"1042",87,14.44,10,318,643,0.0127571771521536,2.02201257861635,2.02201257861635,0.704271248919567,37,238,38,0.458294719457626,1.15636363636364,1.15217391304348,NA,276,275
"1043",87,18.02,11,340,723,0.0125455491931286,2.12647058823529,2.12647058823529,0.724920185580614,49,250,36,0.419784426689148,1.1371237458194,1.18881118881119,NA,286,299
"1044",87,21.5,12,349,753,0.0123999604782136,2.15759312320917,2.15759312320917,0.64037377570762,26,275,43,0.395753890275955,1.15946843853821,1.09748427672956,NA,318,301
"1045",88,2.89,1,163,202,0.015299553131864,1.23926380368098,1.23926380368098,0.830661920064413,24,93,30,0.557910978794098,1.39316239316239,1.32520325203252,NA,123,117
"1046",88,4.14,2,200,287,0.0144221105527638,1.435,1.435,0.874180744029999,34,117,33,0.496394246816635,1.32450331125828,1.33333333333333,NA,150,151
"1047",88,7.62,3,232,349,0.0130243319898492,1.50431034482759,1.50431034482759,0.841307770807032,44,138,37,0.526916861534119,1.27472527472527,1.32571428571429,NA,175,182
"1048",88,7.75,4,244,388,0.0130877690076233,1.59016393442623,1.59016393442623,0.877390767533269,44,139,41,0.49632003903389,1.33333333333333,1.35555555555556,NA,180,183
"1049",88,10.99,5,272,450,0.0122096809203386,1.65441176470588,1.65441176470588,0.798984732290105,46,176,41,0.511382699012756,1.22522522522523,1.25345622119816,NA,217,222
"1050",88,11.77,6,287,487,0.0118661825978899,1.69686411149826,1.69686411149826,0.719770723776309,39,192,50,0.493082970380783,1.24242424242424,1.18595041322314,NA,242,231
"1051",88,15.35,7,313,578,0.011837470303924,1.84664536741214,1.84664536741214,0.763763193641223,47,228,36,0.432033509016037,1.13818181818182,1.18560606060606,NA,264,275
"1052",88,16.05,8,320,611,0.0119710031347962,1.909375,1.909375,0.708856097458787,42,230,42,0.46582967042923,1.17647058823529,1.17647058823529,NA,272,272
"1053",88,18.27,9,332,676,0.0123029883885997,2.03614457831325,2.03614457831325,0.674091260773053,37,253,35,0.437021791934967,1.1448275862069,1.15277777777778,NA,288,290
"1054",88,19.41,10,337,696,0.0122933446375583,2.06528189910979,2.06528189910979,0.732303288761946,40,257,35,0.422263085842133,1.13468013468013,1.1541095890411,NA,292,297
"1055",88,19.98,11,341,722,0.0124547179575643,2.11730205278592,2.11730205278592,0.714125051999116,33,263,37,0.397849291563034,1.15202702702703,1.13666666666667,NA,300,296
"1056",88,21.5,12,349,753,0.0123999604782136,2.15759312320917,2.15759312320917,0.633590296269106,37,277,31,0.446000874042511,1.11146496815287,1.13311688311688,NA,308,314
"1057",89,2.22,1,171,214,0.0147230822153423,1.25146198830409,1.25146198830409,0.953747495968717,42,81,32,0.582452595233917,1.39024390243902,1.51327433628319,NA,113,123
"1058",89,5.8,2,237,355,0.0126939855538869,1.49789029535865,1.49789029535865,0.846303588198565,42,143,41,0.52656614780426,1.28108108108108,1.28804347826087,NA,184,185
"1059",89,6.94,3,247,395,0.0130015470195188,1.59919028340081,1.59919028340081,0.766184959398868,45,156,38,0.506332337856293,1.22885572139303,1.27319587628866,NA,194,201
"1060",89,7.72,4,262,441,0.0128981310871282,1.68320610687023,1.68320610687023,0.734292161235371,33,186,31,0.48361536860466,1.19634703196347,1.2073732718894,NA,217,219
"1061",89,7.85,5,272,472,0.0128065986542218,1.73529411764706,1.73529411764706,0.699192388708307,30,204,34,0.529236853122711,1.16239316239316,1.14285714285714,NA,238,234
"1062",89,10.74,6,294,546,0.0126767430521697,1.85714285714286,1.85714285714286,0.74175122687164,41,218,29,0.435831964015961,1.13513513513514,1.19028340080972,NA,247,259
"1063",89,11.31,7,301,578,0.0128017718715393,1.9202657807309,1.9202657807309,0.653264058516389,32,233,34,0.439808547496796,1.13584905660377,1.12734082397004,NA,267,265
"1064",89,12.56,8,316,620,0.0124573035965441,1.9620253164557,1.9620253164557,0.728499640048254,36,230,41,0.408869713544846,1.18796992481203,1.16605166051661,NA,271,266
"1065",89,14.08,9,325,658,0.0124976258309592,2.02461538461538,2.02461538461538,0.717547222327438,39,243,37,0.40336149930954,1.15248226950355,1.16071428571429,NA,280,282
"1066",89,17.32,10,334,697,0.0125334915754077,2.08682634730539,2.08682634730539,0.695008431128331,36,253,40,0.42609241604805,1.15570934256055,1.13993174061433,NA,293,289
"1067",89,18.02,11,340,723,0.0125455491931286,2.12647058823529,2.12647058823529,0.671670474043535,28,274,34,0.431385099887848,1.12582781456954,1.1038961038961,NA,308,302
"1068",89,21.5,12,349,753,0.0123999604782136,2.15759312320917,2.15759312320917,0.743832878932474,44,265,34,0.430604308843613,1.1294498381877,1.16722408026756,NA,299,309
"1069",90,1.25,1,132,163,0.018852648623641,1.23484848484848,1.23484848484848,0.888574091026833,28,66,27,0.609074473381042,1.40425531914894,1.41935483870968,NA,93,94
"1070",90,3.47,2,215,305,0.0132579873940448,1.41860465116279,1.41860465116279,0.848868704774823,37,126,37,0.553270578384399,1.31901840490798,1.31901840490798,NA,163,163
"1071",90,6.71,3,239,369,0.0129742273478429,1.54393305439331,1.54393305439331,0.752542070375007,33,157,38,0.506675899028778,1.25789473684211,1.22564102564103,NA,195,190
"1072",90,9.6,4,267,457,0.0128692517811382,1.71161048689139,1.71161048689139,0.75719530558933,36,186,36,0.486768007278442,1.2027027027027,1.2027027027027,NA,222,222
"1073",90,9.73,5,276,490,0.0129117259552042,1.77536231884058,1.77536231884058,0.718986577437091,38,197,35,0.493948370218277,1.17446808510638,1.18965517241379,NA,232,235
"1074",90,11.25,6,295,534,0.0123140781736423,1.81016949152542,1.81016949152542,0.70098258067204,30,213,46,0.454435497522354,1.21399176954733,1.13899613899614,NA,259,243
"1075",90,12.39,7,299,555,0.0124576328253013,1.8561872909699,1.8561872909699,0.705346217763226,35,214,43,0.428788244724274,1.20080321285141,1.16342412451362,NA,257,249
"1076",90,13.17,8,309,585,0.0122935317110074,1.89320388349515,1.89320388349515,0.702934680383886,41,221,42,0.457655012607574,1.1793893129771,1.17490494296578,NA,263,262
"1077",90,16.75,9,331,670,0.0122676920260002,2.02416918429003,2.02416918429003,0.740698698021493,37,257,30,0.442164123058319,1.12585034013605,1.15331010452962,NA,287,294
"1078",90,17.45,10,337,697,0.012311007489049,2.06824925816024,2.06824925816024,0.686530415156907,38,254,41,0.448580622673035,1.1541095890411,1.14237288135593,NA,295,292
"1079",90,20.93,11,346,727,0.0121806148948647,2.10115606936416,2.10115606936416,0.675722023810509,33,271,35,0.410669982433319,1.13815789473684,1.13071895424837,NA,306,304
"1080",90,21.5,12,349,753,0.0123999604782136,2.15759312320917,2.15759312320917,0.618803916366048,30,278,37,0.400922238826752,1.13311688311688,1.10793650793651,NA,315,308
"1081",91,1.14,1,114,141,0.0218910107126223,1.23684210526316,1.23684210526316,0.882424459613426,24,62,19,0.588401019573212,1.32558139534884,1.40740740740741,NA,81,86
"1082",91,4.72,2,198,293,0.0150233297441419,1.47979797979798,1.47979797979798,0.868532427674167,39,116,32,0.533751130104065,1.27741935483871,1.33783783783784,NA,148,155
"1083",91,7.61,3,244,398,0.0134250826418404,1.63114754098361,1.63114754098361,0.787352571491741,40,157,37,0.512963652610779,1.23857868020305,1.25773195876289,NA,194,197
"1084",91,11.09,4,263,443,0.0128580965373117,1.68441064638783,1.68441064638783,0.820797782698524,48,174,34,0.506820380687714,1.18468468468468,1.26442307692308,NA,208,222
"1085",91,12.61,5,275,479,0.01271400132714,1.74181818181818,1.74181818181818,0.736293193120071,43,171,50,0.480395793914795,1.28504672897196,1.24434389140271,NA,221,214
"1086",91,13.18,6,286,521,0.0127837075205496,1.82167832167832,1.82167832167832,0.725570108730681,34,211,29,0.477402091026306,1.16734693877551,1.19166666666667,NA,240,245
"1087",91,15.4,7,306,592,0.0126861673631201,1.93464052287582,1.93464052287582,0.753822927546749,36,235,30,0.456872880458832,1.12915129151292,1.15471698113208,NA,265,271
"1088",91,16.1,8,316,625,0.0125577657223227,1.97784810126582,1.97784810126582,0.694790182237295,38,232,39,0.454478055238724,1.17037037037037,1.16605166051661,NA,271,270
"1089",91,16.88,9,325,656,0.0124596391263058,2.01846153846154,2.01846153846154,0.669618179144288,27,251,42,0.46193790435791,1.16906474820144,1.10921501706485,NA,293,278
"1090",91,18.13,10,337,694,0.0122580189345768,2.0593471810089,2.0593471810089,0.713204041733614,35,255,39,0.432172834873199,1.16206896551724,1.14625850340136,NA,294,290
"1091",91,21.37,11,346,731,0.0122476334087292,2.11271676300578,2.11271676300578,0.679302186278452,42,262,37,0.428686797618866,1.13815789473684,1.15719063545151,NA,299,304
"1092",91,21.5,12,349,753,0.0123999604782136,2.15759312320917,2.15759312320917,0.666817972886659,35,272,39,0.430372387170792,1.13680781758958,1.12218649517685,NA,311,307
"1093",92,0.57,1,142,160,0.0159824193387274,1.12676056338028,1.12676056338028,0.967941352042006,31,67,28,0.60595703125,1.44897959183673,1.49473684210526,NA,95,98
"1094",92,0.7,2,168,219,0.0156116338751069,1.30357142857143,1.30357142857143,0.903231714748345,35,85,32,0.512030601501465,1.4,1.43589743589744,NA,117,120
"1095",92,1.84,3,180,273,0.0169459962756052,1.51666666666667,1.51666666666667,0.834807720968297,34,112,29,0.503676414489746,1.23287671232877,1.27659574468085,NA,141,146
"1096",92,4.73,4,229,378,0.0144794300160883,1.65065502183406,1.65065502183406,0.765522939623552,35,153,39,0.508108019828796,1.21808510638298,1.19270833333333,NA,192,188
"1097",92,5.98,5,253,430,0.0134889265324048,1.699604743083,1.699604743083,0.738652193829505,41,163,44,0.467522978782654,1.24019607843137,1.22222222222222,NA,207,204
"1098",92,8.2,6,277,505,0.013210903573484,1.82310469314079,1.82310469314079,0.761772323154719,31,194,42,0.474194705486298,1.23111111111111,1.17372881355932,NA,236,225
"1099",92,11.44,7,291,549,0.0130110202630643,1.88659793814433,1.88659793814433,0.702409636884872,38,214,33,0.454402893781662,1.1547619047619,1.17813765182186,NA,247,252
"1100",92,12.96,8,304,588,0.0127670661803022,1.93421052631579,1.93421052631579,0.721859413407033,33,219,46,0.472067445516586,1.20634920634921,1.14716981132075,NA,265,252
"1101",92,13.66,9,310,616,0.012861467794133,1.98709677419355,1.98709677419355,0.697711844341369,32,238,32,0.445960819721222,1.14814814814815,1.14814814814815,NA,270,270
"1102",92,14.44,10,318,643,0.0127571771521536,2.02201257861635,2.02201257861635,0.651930922866809,29,247,37,0.417527914047241,1.15217391304348,1.11971830985915,NA,284,276
"1103",92,17.92,11,329,675,0.0125101934909927,2.0516717325228,2.0516717325228,0.692506851882574,33,253,40,0.426948755979538,1.15034965034965,1.12286689419795,NA,293,286
"1104",92,21.5,12,349,753,0.0123999604782136,2.15759312320917,2.15759312320917,0.627717542275033,31,282,32,0.411263287067413,1.11501597444089,1.11146496815287,NA,314,313
"1105",93,0.78,1,137,147,0.0157793044224989,1.07299270072993,1.07299270072993,0.956558464954885,36,50,42,0.668240129947662,1.59302325581395,1.48913043478261,NA,92,86
"1106",93,4.36,2,213,299,0.0132429798919302,1.4037558685446,1.4037558685446,0.890504511155773,42,120,38,0.51674473285675,1.31481481481481,1.34810126582278,NA,158,162
"1107",93,5.5,3,230,354,0.0134421872033416,1.53913043478261,1.53913043478261,0.82267313125029,41,136,41,0.497665882110596,1.29943502824859,1.29943502824859,NA,177,177
"1108",93,6.07,4,246,402,0.0133399701343952,1.63414634146341,1.63414634146341,0.798421344646307,43,159,37,0.498267352581024,1.21782178217822,1.25510204081633,NA,196,202
"1109",93,6.77,5,261,446,0.0131447096964338,1.7088122605364,1.7088122605364,0.766342603553501,41,170,46,0.457924544811249,1.23696682464455,1.20833333333333,NA,216,211
"1110",93,10.01,6,282,492,0.0124176573029454,1.74468085106383,1.74468085106383,0.821771048798852,47,186,36,0.468510419130325,1.21030042918455,1.27027027027027,NA,222,233
"1111",93,13.49,7,293,533,0.0124596755341531,1.81911262798635,1.81911262798635,0.768995914047337,36,208,43,0.472274541854858,1.20081967213115,1.16733067729084,NA,251,244
"1112",93,15.01,8,304,566,0.0122893868334202,1.86184210526316,1.86184210526316,0.715824606364664,42,212,43,0.457606494426727,1.19685039370079,1.1921568627451,NA,255,254
"1113",93,15.14,9,308,595,0.0125851347349719,1.93181818181818,1.93181818181818,0.708782443897011,37,224,42,0.455508798360825,1.18007662835249,1.15789473684211,NA,266,261
"1114",93,16.39,10,321,639,0.0124415887850467,1.99065420560748,1.99065420560748,0.725242045373735,32,238,35,0.452400207519531,1.18888888888889,1.17582417582418,NA,273,270
"1115",93,19.28,11,338,695,0.0122030446157358,2.05621301775148,2.05621301775148,0.724516013578445,38,255,38,0.448049277067184,1.15358361774744,1.15358361774744,NA,293,293
"1116",93,21.5,12,349,753,0.0123999604782136,2.15759312320917,2.15759312320917,0.700232012468126,37,281,27,0.42327019572258,1.09748427672956,1.13311688311688,NA,308,318
"1117",94,3.48,1,144,158,0.0153457653457653,1.09722222222222,1.09722222222222,0.871111255835304,28,76,24,0.621535003185272,1.38461538461538,1.44,NA,100,104
"1118",94,4.05,2,185,240,0.0141010575793184,1.2972972972973,1.2972972972973,0.924456361986541,38,94,36,0.538376748561859,1.40151515151515,1.42307692307692,NA,130,132
"1119",94,5.57,3,209,290,0.0133419212366581,1.38755980861244,1.38755980861244,0.78948806914577,38,122,35,0.55269318819046,1.30625,1.3312101910828,NA,157,160
"1120",94,6.27,4,236,345,0.0124413992066354,1.46186440677966,1.46186440677966,0.821180946183891,50,131,49,0.562734723091125,1.30386740331492,1.31111111111111,NA,180,181
"1121",94,9.51,5,264,401,0.0115508699158889,1.51893939393939,1.51893939393939,0.793340315300157,46,157,46,0.523137271404266,1.30049261083744,1.30049261083744,NA,203,203
"1122",94,10.76,6,282,463,0.0116857222180157,1.64184397163121,1.64184397163121,0.803326721094455,49,185,38,0.483402490615845,1.20512820512821,1.26457399103139,NA,223,234
"1123",94,11.9,7,285,492,0.0121571534469978,1.72631578947368,1.72631578947368,0.859092394345005,41,192,38,0.490368247032166,1.22317596566524,1.23913043478261,NA,230,233
"1124",94,12.03,8,289,523,0.0125672818146867,1.80968858131488,1.80968858131488,0.738595186346117,39,203,40,0.47681787610054,1.19421487603306,1.18930041152263,NA,243,242
"1125",94,15.61,9,312,609,0.0125525599802127,1.95192307692308,1.95192307692308,0.741948487806696,39,233,35,0.44828525185585,1.14705882352941,1.16417910447761,NA,268,272
"1126",94,18.5,10,330,668,0.0123054250713825,2.02424242424242,2.02424242424242,0.714286640667066,47,247,35,0.438900649547577,1.12244897959184,1.17021276595745,NA,282,294
"1127",94,20.72,11,342,727,0.0124676304642349,2.12573099415205,2.12573099415205,0.723953931937104,44,256,37,0.417755663394928,1.14,1.16723549488055,NA,293,300
"1128",94,21.5,12,349,753,0.0123999604782136,2.15759312320917,2.15759312320917,0.72107854903015,41,269,34,0.389692187309265,1.1258064516129,1.15181518151815,NA,303,310
"1129",95,1.52,1,120,123,0.0172268907563025,1.025,1.025,0.862122418953523,23,56,28,0.66078394651413,1.51898734177215,1.42857142857143,NA,84,79
"1130",95,2.66,2,164,215,0.0160855903037558,1.3109756097561,1.3109756097561,0.916167893409709,33,86,33,0.527701437473297,1.3781512605042,1.3781512605042,NA,119,119
"1131",95,2.79,3,187,265,0.0152377666609166,1.41711229946524,1.41711229946524,0.800682804803347,27,111,30,0.57542896270752,1.35507246376812,1.32624113475177,NA,141,138
"1132",95,5.01,4,230,365,0.0138598822859313,1.58695652173913,1.58695652173913,0.742279451284322,36,152,35,0.517924547195435,1.22340425531915,1.22994652406417,NA,187,188
"1133",95,5.71,5,250,411,0.0132048192771084,1.644,1.644,0.824340640482998,44,151,47,0.469678103923798,1.28205128205128,1.26262626262626,NA,198,195
"1134",95,6.49,6,264,453,0.0130487383339094,1.71590909090909,1.71590909090909,0.75009838854826,38,176,45,0.455399125814438,1.23364485981308,1.19457013574661,NA,221,214
"1135",95,10.07,7,298,554,0.0125189252706031,1.85906040268456,1.85906040268456,0.759484066738011,34,208,46,0.475322216749191,1.23140495867769,1.17322834645669,NA,254,242
"1136",95,11.32,8,313,599,0.0122675514049316,1.91373801916933,1.91373801916933,0.700477574943384,41,229,41,0.444196075201035,1.15925925925926,1.15925925925926,NA,270,270
"1137",95,14.56,9,324,638,0.0121927913465581,1.96913580246914,1.96913580246914,0.649102170319122,33,253,33,0.470408618450165,1.13286713286713,1.13286713286713,NA,286,286
"1138",95,17.45,10,337,697,0.012311007489049,2.06824925816024,2.06824925816024,0.713368532106384,44,259,34,0.432734876871109,1.11221122112211,1.15017064846416,NA,293,303
"1139",95,20.93,11,346,727,0.0121806148948647,2.10115606936416,2.10115606936416,0.653997162018002,30,272,41,0.431732207536697,1.14569536423841,1.10543130990415,NA,313,302
"1140",95,21.5,12,349,753,0.0123999604782136,2.15759312320917,2.15759312320917,0.63553582149912,32,279,34,0.419505685567856,1.12218649517685,1.11501597444089,NA,313,311
"1141",96,0.57,1,142,160,0.0159824193387274,1.12676056338028,1.12676056338028,0.926662536982481,34,69,27,0.611640632152557,1.37864077669903,1.47916666666667,NA,96,103
"1142",96,4.15,2,212,302,0.0135026379325762,1.42452830188679,1.42452830188679,0.825514522294505,33,124,37,0.57319313287735,1.35031847133758,1.3167701863354,NA,161,157
"1143",96,7.39,3,244,366,0.0123456790123457,1.5,1.5,0.858535242010554,52,139,40,0.545888185501099,1.27748691099476,1.36312849162011,NA,179,191
"1144",96,8.09,4,267,417,0.0117428402466841,1.56179775280899,1.56179775280899,0.817606410555536,49,155,54,0.485970914363861,1.30882352941176,1.27751196172249,NA,209,204
"1145",96,9.61,5,278,456,0.0118432329948316,1.64028776978417,1.64028776978417,0.775341488327301,47,176,50,0.489681988954544,1.24663677130045,1.23008849557522,NA,226,223
"1146",96,10.39,6,289,497,0.011942522106882,1.719723183391,1.719723183391,0.784574404453681,49,191,38,0.488257497549057,1.20416666666667,1.26200873362445,NA,229,240
"1147",96,10.52,7,294,529,0.0122820459241717,1.79931972789116,1.79931972789116,0.707746487803352,32,212,41,0.464833617210388,1.20491803278689,1.16205533596838,NA,253,244
"1148",96,13.41,8,313,599,0.0122675514049316,1.91373801916933,1.91373801916933,0.738192302537878,45,226,37,0.477034628391266,1.1549815498155,1.19011406844106,NA,263,271
"1149",96,16.89,9,324,634,0.0121163475136643,1.95679012345679,1.95679012345679,0.744431902832128,45,238,37,0.472490757703781,1.14487632508834,1.17818181818182,NA,275,283
"1150",96,18.14,10,335,674,0.0120475466976495,2.01194029850746,2.01194029850746,0.720552217159786,40,247,41,0.421205401420593,1.16724738675958,1.16319444444444,NA,288,287
"1151",96,19.28,11,338,695,0.0122030446157358,2.05621301775148,2.05621301775148,0.686719835846868,34,259,39,0.42461159825325,1.15358361774744,1.13422818791946,NA,298,293
"1152",96,21.5,12,349,753,0.0123999604782136,2.15759312320917,2.15759312320917,0.704625903221443,34,267,38,0.426452726125717,1.15946843853821,1.14426229508197,NA,305,301
"1153",97,3.48,1,144,158,0.0153457653457653,1.09722222222222,1.09722222222222,0.959935860744686,37,62,33,0.60242748260498,1.45454545454545,1.51578947368421,NA,95,99
"1154",97,4.05,2,185,240,0.0141010575793184,1.2972972972973,1.2972972972973,0.851733012390699,31,100,41,0.585703134536743,1.41221374045802,1.31205673758865,NA,141,131
"1155",97,7.63,3,236,359,0.012946267580238,1.52118644067797,1.52118644067797,0.841306476196045,52,137,39,0.569730997085571,1.24867724867725,1.34090909090909,NA,176,189
"1156",97,10.87,4,262,416,0.0121669445175631,1.58778625954198,1.58778625954198,0.807903784259503,43,158,44,0.47056445479393,1.30348258706468,1.2970297029703,NA,202,201
"1157",97,11.65,5,276,462,0.0121739130434783,1.67391304347826,1.67391304347826,0.826728101721437,52,170,41,0.468809187412262,1.24324324324324,1.30805687203791,NA,211,222
"1158",97,12.35,6,290,503,0.0120033408901086,1.73448275862069,1.73448275862069,0.781171459783505,47,195,40,0.462127804756165,1.19834710743802,1.23404255319149,NA,235,242
"1159",97,12.48,7,294,534,0.0123981333147594,1.81632653061224,1.81632653061224,0.774670147517931,48,198,43,0.484447151422501,1.19512195121951,1.21991701244813,NA,241,246
"1160",97,13.62,8,297,562,0.0127855127855128,1.89225589225589,1.89225589225589,0.731129384824644,39,207,45,0.462498903274536,1.20731707317073,1.17857142857143,NA,252,246
"1161",97,15.14,9,308,595,0.0125851347349719,1.93181818181818,1.93181818181818,0.677296911943577,32,232,35,0.456384390592575,1.16666666666667,1.15355805243446,NA,267,264
"1162",97,16.39,10,321,639,0.0124415887850467,1.99065420560748,1.99065420560748,0.660359972819937,32,246,41,0.449493139982224,1.15467625899281,1.1184668989547,NA,287,278
"1163",97,19.28,11,338,695,0.0122030446157358,2.05621301775148,2.05621301775148,0.699879843536121,43,250,40,0.455084085464478,1.15358361774744,1.16551724137931,NA,290,293
"1164",97,21.5,12,349,753,0.0123999604782136,2.15759312320917,2.15759312320917,0.685082022670687,36,266,43,0.404716670513153,1.15562913907285,1.1294498381877,NA,309,302
"1165",98,0.7,1,144,151,0.0146658896658897,1.04861111111111,1.04861111111111,0.93226159345839,29,65,33,0.622955143451691,1.53191489361702,1.46938775510204,NA,98,94
"1166",98,1.84,2,163,220,0.0166628796485647,1.34969325153374,1.34969325153374,0.900052147362949,28,91,30,0.591611564159393,1.36974789915966,1.34710743801653,NA,121,119
"1167",98,5.08,3,207,291,0.0136485155480512,1.40579710144928,1.40579710144928,0.805145136328511,36,122,33,0.545742273330688,1.31012658227848,1.33548387096774,NA,155,158
"1168",98,5.86,4,232,344,0.012837736975668,1.48275862068966,1.48275862068966,0.788714267586104,45,138,38,0.513651728630066,1.26775956284153,1.31818181818182,NA,176,183
"1169",98,9.34,5,257,401,0.0121899319066148,1.56031128404669,1.56031128404669,0.755049885607178,40,171,38,0.53663843870163,1.21800947867299,1.22966507177034,NA,209,211
"1170",98,9.47,6,262,432,0.0126349039220848,1.64885496183206,1.64885496183206,0.713950886529197,33,184,34,0.54451459646225,1.2073732718894,1.20183486238532,NA,218,217
"1171",98,12.36,7,287,505,0.0123047684023294,1.7595818815331,1.7595818815331,0.773951639330655,45,183,48,0.478284507989883,1.25877192982456,1.24242424242424,NA,231,228
"1172",98,14.58,8,301,571,0.0126467331118494,1.89700996677741,1.89700996677741,0.734106968083647,38,227,30,0.443249464035034,1.13584905660377,1.17120622568093,NA,257,265
"1173",98,15.15,9,306,603,0.0129218900675024,1.97058823529412,1.97058823529412,0.745778160314115,48,225,29,0.432681798934937,1.12087912087912,1.20472440944882,NA,254,273
"1174",98,18.73,10,331,686,0.0125606518355763,2.07250755287009,2.07250755287009,0.698845978370349,38,252,34,0.443879663944244,1.14137931034483,1.15734265734266,NA,286,290
"1175",98,19.98,11,341,722,0.0124547179575643,2.11730205278592,2.11730205278592,0.675408171039469,35,269,32,0.41413414478302,1.12171052631579,1.1328903654485,NA,301,304
"1176",98,21.5,12,349,753,0.0123999604782136,2.15759312320917,2.15759312320917,0.683277587005728,37,271,38,0.40984708070755,1.13311688311688,1.1294498381877,NA,309,308
"1177",99,2.22,1,171,214,0.0147230822153423,1.25146198830409,1.25146198830409,0.858406778315533,41,77,46,0.606887102127075,1.44915254237288,1.39024390243902,NA,123,118
"1178",99,3.74,2,207,278,0.013038788049341,1.34299516908213,1.34299516908213,0.827868796773316,37,115,42,0.562360882759094,1.36184210526316,1.31847133757962,NA,157,152
"1179",99,3.87,3,222,326,0.0132893074069545,1.46846846846847,1.46846846846847,0.843758004687046,35,138,38,0.514504671096802,1.28323699421965,1.26136363636364,NA,176,173
"1180",99,5.12,4,255,401,0.0123822757449436,1.57254901960784,1.57254901960784,0.810293597826605,48,157,41,0.530746102333069,1.24390243902439,1.28787878787879,NA,198,205
"1181",99,8.7,5,289,501,0.0120386389850058,1.73356401384083,1.73356401384083,0.823174893473272,51,190,44,0.474510043859482,1.19917012448133,1.23504273504274,NA,234,241
"1182",99,9.84,6,294,529,0.0122820459241717,1.79931972789116,1.79931972789116,0.751103205663382,45,198,43,0.475979179143906,1.20987654320988,1.21991701244813,NA,241,243
"1183",99,12.73,7,312,601,0.0123876659246434,1.92628205128205,1.92628205128205,0.698669094724659,37,223,45,0.466265350580215,1.2,1.16417910447761,NA,268,260
"1184",99,13.51,8,322,631,0.0122095160697355,1.95962732919255,1.95962732919255,0.706034885470119,39,245,34,0.448627531528473,1.13380281690141,1.15412186379928,NA,279,284
"1185",99,16.75,9,331,670,0.0122676920260002,2.02416918429003,2.02416918429003,0.698561367451567,38,249,41,0.421513736248016,1.15331010452962,1.14137931034483,NA,290,287
"1186",99,17.32,10,334,697,0.0125334915754077,2.08682634730539,2.08682634730539,0.708762930792769,37,257,35,0.427094757556915,1.13605442176871,1.14383561643836,NA,292,294
"1187",99,18.02,11,340,723,0.0125455491931286,2.12647058823529,2.12647058823529,0.690822175562832,36,259,39,0.430063217878342,1.15254237288136,1.14093959731544,NA,298,295
"1188",99,21.5,12,349,753,0.0123999604782136,2.15759312320917,2.15759312320917,0.662173252826783,30,289,28,0.433112114667892,1.09404388714734,1.10094637223975,NA,317,319
"1189",100,2.89,1,163,202,0.015299553131864,1.23926380368098,1.23926380368098,0.796070420431243,33,85,35,0.591780245304108,1.38135593220339,1.35833333333333,NA,120,118
"1190",100,3.46,2,206,299,0.014160549372484,1.45145631067961,1.45145631067961,0.809512377126537,31,123,38,0.529714465141296,1.33766233766234,1.27950310559006,NA,161,154
"1191",100,4.71,3,233,361,0.01335651916531,1.54935622317597,1.54935622317597,0.764718987954669,37,148,37,0.53622978925705,1.25945945945946,1.25945945945946,NA,185,185
"1192",100,6.93,4,263,450,0.0130612718776304,1.71102661596958,1.71102661596958,0.752240093851341,45,169,43,0.49717777967453,1.22897196261682,1.24056603773585,NA,212,214
"1193",100,8.07,5,268,476,0.0133042651908994,1.77611940298507,1.77611940298507,0.739466828043448,41,176,44,0.459889829158783,1.23502304147465,1.21818181818182,NA,220,217
"1194",100,8.2,6,277,505,0.013210903573484,1.82310469314079,1.82310469314079,0.785722971794095,43,180,44,0.465226918458939,1.24215246636771,1.23660714285714,NA,224,223
"1195",100,11.44,7,291,549,0.0130110202630643,1.88659793814433,1.88659793814433,0.724141941849468,37,215,31,0.482289403676987,1.1547619047619,1.18292682926829,NA,246,252
"1196",100,14.92,8,303,585,0.0127860468166022,1.93069306930693,1.93069306930693,0.706277548609288,36,227,36,0.471195876598358,1.15209125475285,1.15209125475285,NA,263,263
"1197",100,18.5,9,328,667,0.0124375326322071,2.03353658536585,2.03353658536585,0.711545119934167,41,241,41,0.390421032905579,1.16312056737589,1.16312056737589,NA,282,282
"1198",100,20.02,10,336,700,0.0124378109452736,2.08333333333333,2.08333333333333,0.712276987879495,30,266,32,0.41290819644928,1.13513513513514,1.12751677852349,NA,298,296
"1199",100,20.72,11,342,727,0.0124676304642349,2.12573099415205,2.12573099415205,0.712204959961567,41,261,36,0.446309447288513,1.13245033112583,1.15151515151515,NA,297,302
"1200",100,21.5,12,349,753,0.0123999604782136,2.15759312320917,2.15759312320917,0.645175452740962,34,272,39,0.414309084415436,1.14052287581699,1.12218649517685,NA,311,306
