"","replicate","a","a_idx","species","links","connectances","links_per_sp","indegree","sd_gen","S_basal","S_intermediate","S_top","modularity","normalised_outdegree","normalised_indegree","potential_indegree","consumers","resources"
"1",1,2.89,1,163,202,0.015299553131864,1.23926380368098,1.23926380368098,1.32935663673885,48,35,80,0.611067533493042,1.96385542168675,1.41739130434783,6.6,115,83
"2",1,3.67,2,201,283,0.0140796019900498,1.40796019900498,1.40796019900498,1.36853741443069,57,43,101,0.595375120639801,2.01,1.39583333333333,5.84722222222222,144,100
"3",1,5.89,3,241,387,0.0133817427385892,1.60580912863071,1.60580912863071,1.46352053198736,65,51,125,0.555545508861542,2.07758620689655,1.36931818181818,5.375,176,116
"4",1,9.37,4,265,436,0.012464265294454,1.64528301886792,1.64528301886792,1.49847145775524,70,56,139,0.557773470878601,2.1031746031746,1.35897435897436,5.08205128205128,195,126
"5",1,10.51,5,271,466,0.0127374607079404,1.71955719557196,1.71955719557196,1.51263269571395,70,56,145,0.522481501102448,2.15079365079365,1.34825870646766,4.98009950248756,201,126
"6",1,11.76,6,291,515,0.0122052375873919,1.76975945017182,1.76975945017182,1.56955107663521,75,60,156,0.499195009469986,2.15555555555556,1.34722222222222,4.79166666666667,216,135
"7",1,12.33,7,295,547,0.0126138591029632,1.85423728813559,1.85423728813559,1.67521361464765,76,62,157,0.487460225820541,2.13768115942029,1.34703196347032,4.74885844748858,219,138
"8",1,15.91,8,321,631,0.0122858255451713,1.96573208722741,1.96573208722741,1.72294168271834,82,71,168,0.4566670358181,2.09803921568627,1.34309623430962,4.48117154811716,239,153
"9",1,16.04,9,325,653,0.0124026590693257,2.00923076923077,2.00923076923077,1.72209067144287,82,71,172,0.452349752187729,2.12418300653595,1.33744855967078,4.43621399176955,243,153
"10",1,16.74,10,331,682,0.0124874118831823,2.06042296072508,2.06042296072508,1.72914344675884,83,72,176,0.474612146615982,2.13548387096774,1.33467741935484,4.39112903225806,248,155
"11",1,19.98,11,341,722,0.0124547179575643,2.11730205278592,2.11730205278592,1.7696502766845,86,75,180,0.456926554441452,2.11801242236025,1.33725490196078,4.30588235294118,255,161
"12",1,21.5,12,349,753,0.0123999604782136,2.15759312320917,2.15759312320917,1.78717874239867,88,78,183,0.424523204565048,2.10240963855422,1.33716475095785,4.24521072796935,261,166
"13",2,1.14,1,114,141,0.0218910107126223,1.23684210526316,1.23684210526316,1.17486110561291,37,25,52,0.668024718761444,1.83870967741935,1.48051948051948,7.28571428571429,77,62
"14",2,4.03,2,189,274,0.0154227175503771,1.44973544973545,1.44973544973545,1.34873938328823,55,39,95,0.562709808349609,2.01063829787234,1.41044776119403,6.08955223880597,134,94
"15",2,7.61,3,244,398,0.0134250826418404,1.63114754098361,1.63114754098361,1.49901860501922,69,56,119,0.523976683616638,1.952,1.39428571428571,5.27428571428571,175,125
"16",2,8.18,4,261,447,0.0131741821396994,1.71264367816092,1.71264367816092,1.65682800872427,73,60,128,0.494159460067749,1.96240601503759,1.38829787234043,5.04787234042553,188,133
"17",2,11.42,5,283,493,0.0123549607798912,1.74204946996466,1.74204946996466,1.72826285474869,79,64,140,0.485233455896378,1.97902097902098,1.38725490196078,4.82843137254902,204,143
"18",2,12.2,6,293,529,0.0123661695263921,1.80546075085324,1.80546075085324,1.71204713669228,80,65,148,0.491832882165909,2.02068965517241,1.37558685446009,4.70892018779343,213,145
"19",2,13.45,7,308,575,0.0121621049959812,1.86688311688312,1.86688311688312,1.7297896727891,83,67,158,0.458747833967209,2.05333333333333,1.36888888888889,4.58222222222222,225,150
"20",2,13.58,8,313,602,0.0123289915622184,1.92332268370607,1.92332268370607,1.71236355836022,83,67,163,0.456785768270493,2.08666666666667,1.36086956521739,4.52173913043478,230,150
"21",2,15.8,9,326,662,0.0124964605946201,2.03067484662577,2.03067484662577,1.75157316799638,84,70,172,0.44989550113678,2.11688311688312,1.34710743801653,4.44628099173554,242,154
"22",2,19.28,10,335,694,0.0124050406649388,2.07164179104478,2.07164179104478,1.76279126217652,85,74,176,0.429715603590012,2.10691823899371,1.34,4.348,250,159
"23",2,19.98,11,341,722,0.0124547179575643,2.11730205278592,2.11730205278592,1.7696502766845,86,75,180,0.456926554441452,2.11801242236025,1.33725490196078,4.30588235294118,255,161
"24",2,21.5,12,349,753,0.0123999604782136,2.15759312320917,2.15759312320917,1.78717874239867,88,78,183,0.424523204565048,2.10240963855422,1.33716475095785,4.24521072796935,261,166
"25",3,3.58,1,171,218,0.0149982800137599,1.27485380116959,1.27485380116959,1.32365427157769,51,39,81,0.601738095283508,1.9,1.425,6.25833333333333,120,90
"26",3,6.47,2,229,348,0.0133302689037003,1.51965065502183,1.51965065502183,1.45662181261871,65,54,110,0.547735810279846,1.92436974789916,1.39634146341463,5.51829268292683,164,119
"27",3,9.71,3,263,411,0.0119292949815691,1.56273764258555,1.56273764258555,1.56878793099396,75,59,129,0.537428736686707,1.96268656716418,1.39893617021277,5.06914893617021,188,134
"28",3,11.23,4,278,454,0.0117912889904683,1.63309352517986,1.63309352517986,1.59633951582955,79,64,135,0.507520079612732,1.94405594405594,1.39698492462312,4.90452261306533,199,143
"29",3,11.93,5,292,496,0.0116744339311773,1.6986301369863,1.6986301369863,1.62731354992672,81,66,145,0.524626433849335,1.98639455782313,1.38388625592417,4.75829383886256,211,147
"30",3,13.07,6,296,527,0.0120705451213926,1.78040540540541,1.78040540540541,1.65417711706447,81,67,148,0.519403755664825,2,1.37674418604651,4.70697674418605,215,148
"31",3,13.64,7,304,565,0.0122676741358346,1.85855263157895,1.85855263157895,1.72348869348915,82,70,152,0.462150543928146,2,1.36936936936937,4.62162162162162,222,152
"32",3,15.86,8,319,629,0.0124011750556969,1.9717868338558,1.9717868338558,1.755623896154,83,72,164,0.474449068307877,2.05806451612903,1.35169491525424,4.52118644067797,236,155
"33",3,17.11,9,329,673,0.0124731262510193,2.04559270516717,2.04559270516717,1.78647374646938,86,75,168,0.460831582546234,2.04347826086957,1.35390946502058,4.44855967078189,243,161
"34",3,17.24,10,333,697,0.0126089945367054,2.09309309309309,2.09309309309309,1.78340748187943,86,75,172,0.446448087692261,2.06832298136646,1.34817813765182,4.40485829959514,247,161
"35",3,18.02,11,340,723,0.0125455491931286,2.12647058823529,2.12647058823529,1.76872581738239,87,75,178,0.414171606302261,2.09876543209877,1.34387351778656,4.33596837944664,253,162
"36",3,21.5,12,349,753,0.0123999604782136,2.15759312320917,2.15759312320917,1.78717874239867,88,78,183,0.424523204565048,2.10240963855422,1.33716475095785,4.24521072796935,261,166
"37",4,3.58,1,171,218,0.0149982800137599,1.27485380116959,1.27485380116959,1.32365427157769,51,39,81,0.601738095283508,1.9,1.425,6.25833333333333,120,90
"38",4,6.47,2,229,348,0.0133302689037003,1.51965065502183,1.51965065502183,1.45662181261871,65,54,110,0.547735810279846,1.92436974789916,1.39634146341463,5.51829268292683,164,119
"39",4,9.95,3,253,401,0.0125792082313821,1.58498023715415,1.58498023715415,1.54104905079936,72,59,122,0.547403335571289,1.93129770992366,1.39779005524862,5.22099447513812,181,131
"40",4,11.47,4,269,442,0.0122621095267159,1.64312267657993,1.64312267657993,1.5692233126413,76,63,130,0.522427320480347,1.93525179856115,1.39378238341969,5.05181347150259,193,139
"41",4,12.72,5,285,494,0.0122065727699531,1.73333333333333,1.73333333333333,1.62593290292591,79,66,140,0.517462551593781,1.96551724137931,1.38349514563107,4.84466019417476,206,145
"42",4,13.5,6,303,535,0.0116932223023627,1.76567656765677,1.76567656765677,1.62636008028354,81,69,153,0.495141923427582,2.02,1.36486486486486,4.65315315315315,222,150
"43",4,16.74,7,321,584,0.0113707165109034,1.81931464174455,1.81931464174455,1.67271189646569,85,73,163,0.485726654529572,2.03164556962025,1.36016949152542,4.47881355932203,236,158
"44",4,18.96,8,333,657,0.0118853793552589,1.97297297297297,1.97297297297297,1.72661542913888,86,75,172,0.462381452322006,2.06832298136646,1.34817813765182,4.38866396761134,247,161
"45",4,19.66,9,340,684,0.0118688183237897,2.01176470588235,2.01176470588235,1.7479586936763,87,76,177,0.447612106800079,2.08588957055215,1.34387351778656,4.33596837944664,253,163
"46",4,20.23,10,343,713,0.0121562409424923,2.07871720116618,2.07871720116618,1.78201359734658,88,78,177,0.421617984771729,2.06626506024096,1.34509803921569,4.30980392156863,255,166
"47",4,20.36,11,346,735,0.0123146519225936,2.1242774566474,2.1242774566474,1.78126103555556,88,78,180,0.429825574159622,2.08433734939759,1.34108527131783,4.27906976744186,258,166
"48",4,21.5,12,349,753,0.0123999604782136,2.15759312320917,2.15759312320917,1.78717874239867,88,78,183,0.424523204565048,2.10240963855422,1.33716475095785,4.24521072796935,261,166
"49",5,1.25,1,132,163,0.018852648623641,1.23484848484848,1.23484848484848,1.33070044194863,42,28,62,0.615510582923889,1.88571428571429,1.46666666666667,7.02222222222222,90,70
"50",5,4.14,2,200,287,0.0144221105527638,1.435,1.435,1.41557906602171,58,42,100,0.558917820453644,2,1.40845070422535,6.06338028169014,142,100
"51",5,4.71,3,233,361,0.01335651916531,1.54935622317597,1.54935622317597,1.64535516829674,67,51,115,0.542276382446289,1.97457627118644,1.40361445783133,5.45180722891566,166,118
"52",5,5.85,4,240,395,0.0137726638772664,1.64583333333333,1.64583333333333,1.65016936872166,67,52,121,0.498817503452301,2.01680672268908,1.38728323699422,5.31791907514451,173,119
"53",5,7.37,5,262,442,0.0129273785499108,1.68702290076336,1.68702290076336,1.67269452620704,72,59,131,0.50795179605484,2,1.37894736842105,5.09473684210526,190,131
"54",5,9.59,6,284,520,0.0129398297914697,1.83098591549296,1.83098591549296,1.7086488949667,77,63,144,0.488557696342468,2.02857142857143,1.3719806763285,4.90821256038647,207,140
"55",5,13.07,7,296,555,0.0127118644067797,1.875,1.875,1.71837088354309,79,66,151,0.490932524204254,2.04137931034483,1.36405529953917,4.74654377880184,217,145
"56",5,16.31,8,308,594,0.0125639832480223,1.92857142857143,1.92857142857143,1.76284089760722,81,70,157,0.494641989469528,2.03973509933775,1.3568281938326,4.61233480176211,227,151
"57",5,17.01,9,317,622,0.0124186399393044,1.96214511041009,1.96214511041009,1.76815224968701,82,71,164,0.467596232891083,2.0718954248366,1.34893617021277,4.54893617021277,235,153
"58",5,20.59,10,338,703,0.0123435113163486,2.07988165680473,2.07988165680473,1.80370624143701,87,78,173,0.454223811626434,2.04848484848485,1.34661354581673,4.35059760956175,251,165
"59",5,20.72,11,342,727,0.0124676304642349,2.12573099415205,2.12573099415205,1.80164285871487,87,78,177,0.454396992921829,2.07272727272727,1.34117647058824,4.30980392156863,255,165
"60",5,21.5,12,349,753,0.0123999604782136,2.15759312320917,2.15759312320917,1.78717874239867,88,78,183,0.424523204565048,2.10240963855422,1.33716475095785,4.24521072796935,261,166
"61",6,0.57,1,142,160,0.0159824193387274,1.12676056338028,1.12676056338028,1.50917260456006,45,31,66,0.703574180603027,1.86842105263158,1.4639175257732,6.31958762886598,97,76
"62",6,1.35,2,185,236,0.0138660399529965,1.27567567567568,1.27567567567568,1.50135561108008,55,38,92,0.618060648441315,1.98924731182796,1.42307692307692,6.03846153846154,130,93
"63",6,4.24,3,227,349,0.0136057073798292,1.5374449339207,1.5374449339207,1.59933771184932,65,48,114,0.541567862033844,2.00884955752212,1.40123456790123,5.45679012345679,162,113
"64",6,4.94,4,244,392,0.0132226944613101,1.60655737704918,1.60655737704918,1.57115232634993,67,51,126,0.520232439041138,2.06779661016949,1.37853107344633,5.22033898305085,177,118
"65",6,6.46,5,265,434,0.0124070897655803,1.6377358490566,1.6377358490566,1.59757041908353,71,56,138,0.510151028633118,2.08661417322835,1.3659793814433,5.06185567010309,194,127
"66",6,10.04,6,292,529,0.0124511603822436,1.81164383561644,1.81164383561644,1.64696455554565,79,67,146,0.474314033985138,2,1.37089201877934,4.74647887323944,213,146
"67",6,13.52,7,304,564,0.0122459614382491,1.85526315789474,1.85526315789474,1.66741834690331,80,70,154,0.495171248912811,2.02666666666667,1.35714285714286,4.62946428571429,224,150
"68",6,13.65,8,308,591,0.0125005287871737,1.91883116883117,1.91883116883117,1.66961460756664,80,70,158,0.452881783246994,2.05333333333333,1.35087719298246,4.57894736842105,228,150
"69",6,14.9,9,321,631,0.0122858255451713,1.96573208722741,1.96573208722741,1.69549869777969,83,72,166,0.445485651493073,2.07096774193548,1.34873949579832,4.46638655462185,238,155
"70",6,17.12,10,336,696,0.0123667377398721,2.07142857142857,2.07142857142857,1.74725013331742,86,75,175,0.436958074569702,2.08695652173913,1.344,4.376,250,161
"71",6,18.26,11,340,716,0.012424084678119,2.10588235294118,2.10588235294118,1.75191769590306,86,75,179,0.429503411054611,2.11180124223602,1.33858267716535,4.32677165354331,254,161
"72",6,21.5,12,349,753,0.0123999604782136,2.15759312320917,2.15759312320917,1.78717874239867,88,78,183,0.424523204565048,2.10240963855422,1.33716475095785,4.24521072796935,261,166
"73",7,1.52,1,120,123,0.0172268907563025,1.025,1.025,1.07664941419089,38,25,57,0.737590074539185,1.9047619047619,1.46341463414634,7.03658536585366,82,63
"74",7,4.41,2,211,284,0.0128187767998195,1.34597156398104,1.34597156398104,1.36778047020215,63,45,103,0.598021268844604,1.9537037037037,1.42567567567568,5.79054054054054,148,108
"75",7,5.66,3,239,355,0.0124819802397947,1.48535564853556,1.48535564853556,1.46417221199798,69,51,119,0.54265022277832,1.99166666666667,1.40588235294118,5.46470588235294,170,120
"76",7,6.23,4,255,411,0.012691060676239,1.61176470588235,1.61176470588235,1.65831767615852,72,58,125,0.519742965698242,1.96153846153846,1.39344262295082,5.20765027322404,183,130
"77",7,9.81,5,284,507,0.0126163340466829,1.78521126760563,1.78521126760563,1.69718115687589,79,67,138,0.497899204492569,1.94520547945205,1.38536585365854,4.85365853658537,205,146
"78",7,10.95,6,290,536,0.0127908364157022,1.84827586206897,1.84827586206897,1.70895654883086,79,68,143,0.490280032157898,1.97278911564626,1.37440758293839,4.76303317535545,211,147
"79",7,14.19,7,307,579,0.012326754806157,1.88599348534202,1.88599348534202,1.76299355499302,84,72,151,0.477413207292557,1.96794871794872,1.37668161434978,4.60538116591928,223,156
"80",7,14.97,8,317,611,0.0121990176895739,1.92744479495268,1.92744479495268,1.73928239453213,85,72,160,0.456166416406631,2.01910828025478,1.36637931034483,4.50431034482759,232,157
"81",7,15.67,9,325,640,0.0121557454890788,1.96923076923077,1.96923076923077,1.7399371902521,86,73,166,0.46069210767746,2.0440251572327,1.35983263598326,4.43514644351464,239,159
"82",7,19.15,10,335,670,0.0119760479041916,2,2,1.76246629050025,87,76,172,0.442346781492233,2.05521472392638,1.3508064516129,4.34274193548387,248,163
"83",7,19.28,11,338,695,0.0122030446157358,2.05621301775148,2.05621301775148,1.754077781403,87,76,175,0.441011279821396,2.07361963190184,1.34661354581673,4.31075697211155,251,163
"84",7,21.5,12,349,753,0.0123999604782136,2.15759312320917,2.15759312320917,1.78717874239867,88,78,183,0.424523204565048,2.10240963855422,1.33716475095785,4.24521072796935,261,166
"85",8,2.22,1,171,214,0.0147230822153423,1.25146198830409,1.25146198830409,1.28872700047602,51,39,81,0.66843169927597,1.9,1.425,6.475,120,90
"86",8,3,2,199,277,0.0140601999898482,1.39195979899497,1.39195979899497,1.30907498832681,55,42,102,0.63313090801239,2.05154639175258,1.38194444444444,5.92361111111111,144,97
"87",8,4.25,3,236,357,0.0128741435268662,1.51271186440678,1.51271186440678,1.51297640425231,67,49,120,0.573233246803284,2.03448275862069,1.39644970414201,5.49112426035503,169,116
"88",8,4.82,4,252,403,0.0127426800733574,1.59920634920635,1.59920634920635,1.66451606536562,71,52,129,0.555301785469055,2.04878048780488,1.39226519337017,5.29281767955801,181,123
"89",8,8.4,5,289,504,0.0121107266435986,1.7439446366782,1.7439446366782,1.7166012776232,80,61,148,0.509586036205292,2.04964539007092,1.38277511961722,4.89473684210526,209,141
"90",8,11.29,6,305,575,0.0124029335634167,1.88524590163934,1.88524590163934,1.71313741916218,81,67,157,0.498511910438538,2.06081081081081,1.36160714285714,4.66964285714286,224,148
"91",8,11.99,7,313,606,0.0124109117719341,1.93610223642173,1.93610223642173,1.71471897107089,82,69,162,0.4533351957798,2.07284768211921,1.35497835497835,4.59307359307359,231,151
"92",8,15.23,8,325,648,0.0123076923076923,1.99384615384615,1.99384615384615,1.75827097388333,85,72,168,0.470314621925354,2.07006369426752,1.35416666666667,4.475,240,157
"93",8,16.75,9,333,682,0.0123376388436629,2.04804804804805,2.04804804804805,1.76480654272335,87,75,171,0.459800958633423,2.05555555555556,1.35365853658537,4.40650406504065,246,162
"94",8,20.23,10,343,713,0.0121562409424923,2.07871720116618,2.07871720116618,1.78201359734658,88,78,177,0.421617984771729,2.06626506024096,1.34509803921569,4.30980392156863,255,166
"95",8,20.36,11,346,735,0.0123146519225936,2.1242774566474,2.1242774566474,1.78126103555556,88,78,180,0.429825574159622,2.08433734939759,1.34108527131783,4.27906976744186,258,166
"96",8,21.5,12,349,753,0.0123999604782136,2.15759312320917,2.15759312320917,1.78717874239867,88,78,183,0.424523204565048,2.10240963855422,1.33716475095785,4.24521072796935,261,166
"97",9,2.89,1,163,202,0.015299553131864,1.23926380368098,1.23926380368098,1.32935663673885,48,35,80,0.611067533493042,1.96385542168675,1.41739130434783,6.6,115,83
"98",9,3.46,2,206,299,0.014160549372484,1.45145631067961,1.45145631067961,1.62684052929615,62,46,98,0.565497040748596,1.90740740740741,1.43055555555556,5.72222222222222,144,108
"99",9,4.98,3,230,349,0.0132523258021644,1.51739130434783,1.51739130434783,1.61863593492106,67,53,110,0.532934904098511,1.91666666666667,1.41104294478528,5.42331288343558,163,120
"100",9,8.46,4,249,396,0.0128254955305091,1.59036144578313,1.59036144578313,1.64153269241282,69,56,124,0.545486390590668,1.992,1.38333333333333,5.21111111111111,180,125
"101",9,12.04,5,281,491,0.0124809354346721,1.74733096085409,1.74733096085409,1.68286250035709,77,67,137,0.506093382835388,1.95138888888889,1.37745098039216,4.88725490196078,204,144
"102",9,12.82,6,294,530,0.0123052634022892,1.80272108843537,1.80272108843537,1.66842347622917,79,69,146,0.499955505132675,1.98648648648649,1.36744186046512,4.74883720930233,215,148
"103",9,16.06,7,311,574,0.0119074784773364,1.84565916398714,1.84565916398714,1.71793845175307,83,73,155,0.478883117437363,1.99358974358974,1.3640350877193,4.57017543859649,228,156
"104",9,18.28,8,324,644,0.0123074570958988,1.98765432098765,1.98765432098765,1.75444957770324,84,75,165,0.438137799501419,2.0377358490566,1.35,4.45833333333333,240,159
"105",9,19.53,9,336,687,0.0122068230277186,2.04464285714286,2.04464285714286,1.77578716697812,87,77,172,0.452798783779144,2.04878048780488,1.34939759036145,4.36144578313253,249,164
"106",9,20.67,10,339,705,0.0123055977378646,2.07964601769911,2.07964601769911,1.78176726667352,87,77,175,0.462940514087677,2.06707317073171,1.3452380952381,4.32539682539683,252,164
"107",9,21.37,11,346,731,0.0122476334087292,2.11271676300578,2.11271676300578,1.78827717377754,88,78,180,0.458441913127899,2.08433734939759,1.34108527131783,4.27519379844961,258,166
"108",9,21.5,12,349,753,0.0123999604782136,2.15759312320917,2.15759312320917,1.78717874239867,88,78,183,0.424523204565048,2.10240963855422,1.33716475095785,4.24521072796935,261,166
"109",10,3.48,1,144,158,0.0153457653457653,1.09722222222222,1.09722222222222,1.24917081106252,45,30,69,0.688811957836151,1.92,1.45454545454545,6.97979797979798,99,75
"110",10,5.7,2,211,290,0.0130895960279847,1.37440758293839,1.37440758293839,1.39450721028946,61,45,105,0.627865612506866,1.99056603773585,1.40666666666667,5.81333333333333,150,106
"111",10,8.94,3,234,352,0.0129122189208026,1.5042735042735,1.5042735042735,1.5400553839988,67,52,115,0.568674147129059,1.96638655462185,1.40119760479042,5.44311377245509,167,119
"112",10,9.72,4,255,402,0.0124131542380732,1.57647058823529,1.57647058823529,1.54573558952522,70,54,131,0.568964898586273,2.05645161290323,1.37837837837838,5.16756756756757,185,124
"113",10,11.24,5,271,442,0.0120814541478748,1.6309963099631,1.6309963099631,1.56765232724358,73,59,139,0.536495923995972,2.0530303030303,1.36868686868687,4.97474747474747,198,132
"114",10,14.82,6,300,540,0.0120401337792642,1.8,1.8,1.68177224998561,81,68,151,0.469413578510284,2.01342281879195,1.36986301369863,4.72602739726027,219,149
"115",10,15.96,7,304,568,0.0123328122285913,1.86842105263158,1.86842105263158,1.71819174122883,81,69,154,0.465622514486313,2.02666666666667,1.36322869955157,4.66367713004484,223,150
"116",10,16.53,8,309,598,0.0125667213045854,1.93527508090615,1.93527508090615,1.78481499904932,82,71,156,0.463251233100891,2.01960784313725,1.36123348017621,4.61674008810573,227,153
"117",10,17.78,9,325,646,0.0122697056030389,1.98769230769231,1.98769230769231,1.80745625817637,86,73,166,0.459309041500092,2.0440251572327,1.35983263598326,4.49372384937239,239,159
"118",10,18.48,10,334,676,0.0121558684432936,2.02395209580838,2.02395209580838,1.80653294322036,87,74,173,0.443910598754883,2.07453416149068,1.35222672064777,4.40890688259109,247,161
"119",10,18.61,11,337,699,0.0123463331920305,2.07418397626113,2.07418397626113,1.79914578954811,87,74,176,0.450145363807678,2.09316770186335,1.348,4.376,250,161
"120",10,21.5,12,349,753,0.0123999604782136,2.15759312320917,2.15759312320917,1.78717874239867,88,78,183,0.424523204565048,2.10240963855422,1.33716475095785,4.24521072796935,261,166
"121",11,1.25,1,132,163,0.018852648623641,1.23484848484848,1.23484848484848,1.33070044194863,42,28,62,0.615510582923889,1.88571428571429,1.46666666666667,7.02222222222222,90,70
"122",11,2.77,2,188,245,0.013937876891569,1.3031914893617,1.3031914893617,1.37875802917873,60,41,87,0.568646371364594,1.86138613861386,1.46875,6.078125,128,101
"123",11,5.66,3,239,355,0.0124819802397947,1.48535564853556,1.48535564853556,1.46417221199798,69,51,119,0.54265022277832,1.99166666666667,1.40588235294118,5.46470588235294,170,120
"124",11,8.9,4,269,416,0.0115408089663208,1.54646840148699,1.54646840148699,1.55743719374375,76,58,135,0.547117710113525,2.00746268656716,1.39378238341969,5.03626943005181,193,134
"125",11,9.6,5,282,458,0.0115595265137175,1.6241134751773,1.6241134751773,1.60196690350666,78,61,143,0.497323155403137,2.02877697841727,1.38235294117647,4.91176470588235,204,139
"126",11,9.73,6,286,491,0.0120476015212857,1.71678321678322,1.71678321678322,1.61026359649505,78,61,147,0.488095253705978,2.05755395683453,1.375,4.85096153846154,208,139
"127",11,10.51,7,299,523,0.0117393548966353,1.74916387959866,1.74916387959866,1.59178703320068,79,63,157,0.472284495830536,2.1056338028169,1.35909090909091,4.69545454545455,220,142
"128",11,13.99,8,312,558,0.0115013603759584,1.78846153846154,1.78846153846154,1.61918770134454,81,66,165,0.470635712146759,2.12244897959184,1.35064935064935,4.56709956709957,231,147
"129",11,14.56,9,315,593,0.0119906986149024,1.88253968253968,1.88253968253968,1.70703073106734,82,68,165,0.465794026851654,2.1,1.3519313304721,4.53648068669528,233,150
"130",11,16.78,10,326,656,0.0123831996224634,2.01226993865031,2.01226993865031,1.75210498291026,83,71,172,0.451182335615158,2.11688311688312,1.34156378600823,4.45679012345679,243,154
"131",11,20.36,11,346,735,0.0123146519225936,2.1242774566474,2.1242774566474,1.78126103555556,88,78,180,0.429825574159622,2.08433734939759,1.34108527131783,4.27906976744186,258,166
"132",11,21.5,12,349,753,0.0123999604782136,2.15759312320917,2.15759312320917,1.78717874239867,88,78,183,0.424523204565048,2.10240963855422,1.33716475095785,4.24521072796935,261,166
"133",12,1.14,1,114,141,0.0218910107126223,1.23684210526316,1.23684210526316,1.17486110561291,37,25,52,0.668024718761444,1.83870967741935,1.48051948051948,7.28571428571429,77,62
"134",12,2.39,2,167,237,0.0170983334535748,1.41916167664671,1.41916167664671,1.40573239953255,51,38,78,0.59302282333374,1.87640449438202,1.43965517241379,6.43103448275862,116,89
"135",12,3.09,3,199,302,0.0153291711080656,1.51758793969849,1.51758793969849,1.5041384768936,57,43,99,0.560479760169983,1.99,1.40140845070423,5.95774647887324,142,100
"136",12,3.66,4,220,356,0.0147779161477792,1.61818181818182,1.61818181818182,1.65353572586575,63,50,107,0.519584059715271,1.94690265486726,1.40127388535032,5.61146496815287,157,113
"137",12,7.14,5,239,404,0.0142048451179635,1.69037656903766,1.69037656903766,1.66138528081409,66,53,120,0.509248435497284,2.00840336134454,1.38150289017341,5.32369942196532,173,119
"138",12,7.27,6,247,438,0.0144169053026563,1.77327935222672,1.77327935222672,1.65676664201424,67,54,126,0.497388452291489,2.04132231404959,1.37222222222222,5.18888888888889,180,121
"139",12,10.51,7,269,486,0.0134827720135383,1.80669144981413,1.80669144981413,1.73784381569532,73,59,137,0.459836333990097,2.03787878787879,1.37244897959184,4.95408163265306,196,132
"140",12,12.03,8,289,523,0.0125672818146867,1.80968858131488,1.80968858131488,1.77944086373962,79,64,146,0.448744058609009,2.02097902097902,1.37619047619048,4.8,210,143
"141",12,14.25,9,306,586,0.0125575913425479,1.91503267973856,1.91503267973856,1.80340285923188,81,67,158,0.446567565202713,2.06756756756757,1.36,4.68,225,148
"142",12,15.03,10,315,616,0.0124557678697806,1.95555555555556,1.95555555555556,1.77783938411692,82,67,166,0.439757138490677,2.11409395973154,1.3519313304721,4.57510729613734,233,149
"143",12,17.92,11,329,675,0.0125101934909927,2.0516717325228,2.0516717325228,1.76028004046815,83,71,175,0.41419917345047,2.13636363636364,1.33739837398374,4.41869918699187,246,154
"144",12,21.5,12,349,753,0.0123999604782136,2.15759312320917,2.15759312320917,1.78717874239867,88,78,183,0.424523204565048,2.10240963855422,1.33716475095785,4.24521072796935,261,166
"145",13,2.89,1,163,202,0.015299553131864,1.23926380368098,1.23926380368098,1.32935663673885,48,35,80,0.611067533493042,1.96385542168675,1.41739130434783,6.6,115,83
"146",13,6.47,2,229,348,0.0133302689037003,1.51965065502183,1.51965065502183,1.45662181261871,65,54,110,0.547735810279846,1.92436974789916,1.39634146341463,5.51829268292683,164,119
"147",13,8.69,3,268,452,0.0126334619039633,1.6865671641791,1.6865671641791,1.58070658453042,74,62,132,0.492175906896591,1.97058823529412,1.38144329896907,5.05154639175258,194,136
"148",13,10.21,4,284,495,0.0123177225899567,1.74295774647887,1.74295774647887,1.61855276942921,79,66,139,0.526062607765198,1.95862068965517,1.38536585365854,4.88780487804878,205,145
"149",13,13.69,5,296,532,0.0121850664223546,1.7972972972973,1.7972972972973,1.63642312147876,80,69,147,0.513262152671814,1.98657718120805,1.37037037037037,4.74537037037037,216,149
"150",13,16.93,6,309,575,0.0120833858697936,1.86084142394822,1.86084142394822,1.69192002078638,82,72,155,0.483193904161453,2.00649350649351,1.36123348017621,4.59911894273128,227,154
"151",13,17.71,7,320,612,0.0119905956112853,1.9125,1.9125,1.6887505738761,83,73,164,0.444504529237747,2.05128205128205,1.35021097046413,4.49789029535865,237,156
"152",13,18.85,8,323,634,0.0121916043305194,1.96284829721362,1.96284829721362,1.69910841682375,83,73,167,0.47462409734726,2.07051282051282,1.34583333333333,4.45833333333333,240,156
"153",13,18.98,9,327,658,0.0123449841466389,2.01223241590214,2.01223241590214,1.70292784955964,83,73,171,0.431922793388367,2.09615384615385,1.34016393442623,4.41393442622951,244,156
"154",13,20.23,10,340,700,0.0121464515009544,2.05882352941176,2.05882352941176,1.73486315470499,86,75,179,0.425655126571655,2.11180124223603,1.33858267716535,4.31102362204724,254,161
"155",13,20.8,11,343,727,0.0123949329105076,2.11953352769679,2.11953352769679,1.78112268408736,87,77,179,0.410857290029526,2.09146341463415,1.33984375,4.28515625,256,164
"156",13,21.5,12,349,753,0.0123999604782136,2.15759312320917,2.15759312320917,1.78717874239867,88,78,183,0.424523204565048,2.10240963855422,1.33716475095785,4.24521072796935,261,166
"157",14,3.48,1,144,158,0.0153457653457653,1.09722222222222,1.09722222222222,1.24917081106252,45,30,69,0.688811957836151,1.92,1.45454545454545,6.97979797979798,99,75
"158",14,6.37,2,206,286,0.0135448733128108,1.38834951456311,1.38834951456311,1.40582375343957,61,45,100,0.597541451454163,1.94339622641509,1.42068965517241,5.81379310344828,145,106
"159",14,7.62,3,232,349,0.0130243319898492,1.50431034482759,1.50431034482759,1.47545808505918,67,50,115,0.561210513114929,1.98290598290598,1.40606060606061,5.49090909090909,165,117
"160",14,11.2,4,270,454,0.0125017210519069,1.68148148148148,1.68148148148148,1.59157967404114,76,62,132,0.537338197231293,1.95652173913043,1.39175257731959,4.98969072164948,194,138
"161",14,11.9,5,281,495,0.0125826131164209,1.76156583629893,1.76156583629893,1.62523365581399,77,64,140,0.517963409423828,1.99290780141844,1.37745098039216,4.86274509803922,204,141
"162",14,15.14,6,304,549,0.0119202709744659,1.80592105263158,1.80592105263158,1.6789406830779,83,69,152,0.504190444946289,2,1.37556561085973,4.63800904977376,221,152
"163",14,16.66,7,316,582,0.0116937914406269,1.84177215189873,1.84177215189873,1.70331854416346,85,72,159,0.471714407205582,2.01273885350318,1.36796536796537,4.53246753246753,231,157
"164",14,17.8,8,319,608,0.0119871453638532,1.90595611285266,1.90595611285266,1.72945314179051,85,73,161,0.452919363975525,2.01898734177215,1.36324786324786,4.49145299145299,234,158
"165",14,20.02,9,333,675,0.0122110061869098,2.02702702702703,2.02702702702703,1.77021950854512,86,76,171,0.448737472295761,2.05555555555556,1.34817813765182,4.38461538461539,247,162
"166",14,20.15,10,337,699,0.0123463331920305,2.07418397626113,2.07418397626113,1.76811799329831,86,76,175,0.466333448886871,2.08024691358025,1.34262948207171,4.34262948207171,251,162
"167",14,20.93,11,346,727,0.0121806148948647,2.10115606936416,2.10115606936416,1.75428805533464,87,76,183,0.430474996566772,2.12269938650307,1.33590733590734,4.27027027027027,259,163
"168",14,21.5,12,349,753,0.0123999604782136,2.15759312320917,2.15759312320917,1.78717874239867,88,78,183,0.424523204565048,2.10240963855422,1.33716475095785,4.24521072796935,261,166
"169",15,0.13,1,110,118,0.0196830692243536,1.07272727272727,1.07272727272727,1.0390487353936,31,22,57,0.75061047077179,2.07547169811321,1.39240506329114,6.9873417721519,79,53
"170",15,0.91,2,167,203,0.0146454079792223,1.21556886227545,1.21556886227545,1.13905172275589,47,32,88,0.677703976631165,2.11392405063291,1.39166666666667,6.20833333333333,120,79
"171",15,4.15,3,213,293,0.0129772344760386,1.37558685446009,1.37558685446009,1.38540316328527,59,44,110,0.626483738422394,2.06796116504854,1.38311688311688,5.42857142857143,154,103
"172",15,5.29,4,222,336,0.0136969548734255,1.51351351351351,1.51351351351351,1.47235251773035,61,47,114,0.595105230808258,2.05555555555556,1.37888198757764,5.27950310559006,161,108
"173",15,7.51,5,247,417,0.0137256838155426,1.68825910931174,1.68825910931174,1.52984383081905,65,51,131,0.535321414470673,2.12931034482759,1.35714285714286,5.15384615384615,182,116
"174",15,10.99,6,267,464,0.0130663737996677,1.73782771535581,1.73782771535581,1.60664517757726,70,55,142,0.53115713596344,2.136,1.35532994923858,4.9746192893401,197,125
"175",15,13.88,7,292,538,0.012662994868898,1.84246575342466,1.84246575342466,1.61882321749091,74,61,157,0.489719927310944,2.16296296296296,1.3394495412844,4.72477064220184,218,135
"176",15,17.46,8,318,625,0.0124000555522489,1.96540880503145,1.96540880503145,1.6849850509966,81,70,167,0.465815037488937,2.10596026490066,1.34177215189873,4.48945147679325,237,151
"177",15,18.16,9,326,658,0.012420953279849,2.01840490797546,2.01840490797546,1.70696620146864,82,71,173,0.459771513938904,2.13071895424837,1.33606557377049,4.41393442622951,244,153
"178",15,19.68,10,335,689,0.0123156671731165,2.05671641791045,2.05671641791045,1.72496265247659,84,74,177,0.447749316692352,2.12025316455696,1.33466135458167,4.34262948207171,251,158
"179",15,20.25,11,339,717,0.0125150547206367,2.11504424778761,2.11504424778761,1.7706587744849,85,76,178,0.435257375240326,2.1055900621118,1.33464566929134,4.30708661417323,254,161
"180",15,21.5,12,349,753,0.0123999604782136,2.15759312320917,2.15759312320917,1.78717874239867,88,78,183,0.424523204565048,2.10240963855422,1.33716475095785,4.24521072796935,261,166
"181",16,1.14,1,114,141,0.0218910107126223,1.23684210526316,1.23684210526316,1.17486110561291,37,25,52,0.668024718761444,1.83870967741935,1.48051948051948,7.28571428571429,77,62
"182",16,4.72,2,198,293,0.0150233297441419,1.47979797979798,1.47979797979798,1.427783722339,61,46,91,0.538765668869019,1.85046728971963,1.44525547445255,5.91970802919708,137,107
"183",16,5.97,3,228,369,0.0142592163227452,1.61842105263158,1.61842105263158,1.55397105346665,68,53,107,0.494983851909637,1.88429752066116,1.425,5.475,160,121
"184",16,9.45,4,250,419,0.0134618473895582,1.676,1.676,1.60187645905098,73,57,120,0.525694787502289,1.92307692307692,1.41242937853107,5.20338983050847,177,130
"185",16,12.34,5,279,493,0.012712410716588,1.76702508960573,1.76702508960573,1.61352362940672,76,63,140,0.502157986164093,2.00719424460432,1.3743842364532,4.83251231527094,203,139
"186",16,13.12,6,297,531,0.0120802620802621,1.78787878787879,1.78787878787879,1.61297643324856,78,65,154,0.507829070091248,2.07692307692308,1.35616438356164,4.63926940639269,219,143
"187",16,15.34,7,317,604,0.0120592580761091,1.90536277602524,1.90536277602524,1.66940237758282,81,69,167,0.469095408916473,2.11333333333333,1.34322033898305,4.51694915254237,236,150
"188",16,18.58,8,327,645,0.0121010862835594,1.97247706422018,1.97247706422018,1.71505260430588,84,72,171,0.460727155208588,2.09615384615385,1.34567901234568,4.4238683127572,243,156
"189",16,20.1,9,336,678,0.012046908315565,2.01785714285714,2.01785714285714,1.73454346446168,86,75,175,0.471806734800339,2.08695652173913,1.344,4.352,250,161
"190",16,20.8,10,343,705,0.0120198455321978,2.05539358600583,2.05539358600583,1.75496877888098,87,76,180,0.461600542068481,2.10429447852761,1.33984375,4.30078125,256,163
"191",16,20.93,11,346,727,0.0121806148948647,2.10115606936416,2.10115606936416,1.75428805533464,87,76,183,0.430474996566772,2.12269938650307,1.33590733590734,4.27027027027027,259,163
"192",16,21.5,12,349,753,0.0123999604782136,2.15759312320917,2.15759312320917,1.78717874239867,88,78,183,0.424523204565048,2.10240963855422,1.33716475095785,4.24521072796935,261,166
"193",17,1.14,1,114,141,0.0218910107126223,1.23684210526316,1.23684210526316,1.17486110561291,37,25,52,0.668024718761444,1.83870967741935,1.48051948051948,7.28571428571429,77,62
"194",17,1.92,2,164,221,0.0165344904982792,1.34756097560976,1.34756097560976,1.28030445345776,48,32,84,0.617493510246277,2.05,1.41379310344828,6.18103448275862,116,80
"195",17,3.17,3,204,300,0.0144885540423066,1.47058823529412,1.47058823529412,1.44354244077724,59,41,104,0.5886110663414,2.04,1.40689655172414,5.64137931034483,145,100
"196",17,3.74,4,225,353,0.0140079365079365,1.56888888888889,1.56888888888889,1.62570123494219,65,47,113,0.538002908229828,2.00892857142857,1.40625,5.4125,160,112
"197",17,3.87,5,235,386,0.0140389161665757,1.64255319148936,1.64255319148936,1.6048316832771,65,48,122,0.556068599224091,2.07964601769912,1.38235294117647,5.27647058823529,170,113
"198",17,6.76,6,266,464,0.013164987941552,1.74436090225564,1.74436090225564,1.63541201872881,70,53,143,0.513650953769684,2.16260162601626,1.35714285714286,4.94897959183673,196,123
"199",17,10,7,284,511,0.012715871198925,1.79929577464789,1.79929577464789,1.69219228582548,76,58,150,0.479758441448212,2.11940298507463,1.36538461538462,4.77884615384615,208,134
"200",17,10.7,8,291,544,0.0128925228107596,1.86941580756014,1.86941580756014,1.68253158421474,77,61,153,0.449943542480469,2.10869565217391,1.35981308411215,4.7196261682243,214,138
"201",17,14.28,9,319,632,0.0124603221545317,1.98119122257053,1.98119122257053,1.71516026671913,84,70,165,0.463219583034515,2.07142857142857,1.35744680851064,4.47234042553191,235,154
"202",17,16.5,10,332,690,0.0125577840061151,2.07831325301205,2.07831325301205,1.75707128910711,85,72,175,0.437548786401749,2.11464968152866,1.34412955465587,4.40080971659919,247,157
"203",17,19.98,11,341,722,0.0124547179575643,2.11730205278592,2.11730205278592,1.7696502766845,86,75,180,0.456926554441452,2.11801242236025,1.33725490196078,4.30588235294118,255,161
"204",17,21.5,12,349,753,0.0123999604782136,2.15759312320917,2.15759312320917,1.78717874239867,88,78,183,0.424523204565048,2.10240963855422,1.33716475095785,4.24521072796935,261,166
"205",18,3.58,1,171,218,0.0149982800137599,1.27485380116959,1.27485380116959,1.32365427157769,51,39,81,0.601738095283508,1.9,1.425,6.25833333333333,120,90
"206",18,3.71,2,202,281,0.0138416826757303,1.39108910891089,1.39108910891089,1.36441813213404,59,43,100,0.584104776382446,1.98039215686275,1.41258741258741,5.81818181818182,143,102
"207",18,4.96,3,229,362,0.0138665440894813,1.58078602620087,1.58078602620087,1.51039421412546,67,50,112,0.488954037427902,1.95726495726496,1.41358024691358,5.45679012345679,162,117
"208",18,5.66,4,246,411,0.0136386261821802,1.67073170731707,1.67073170731707,1.55908132242084,71,53,122,0.511940479278564,1.98387096774194,1.40571428571429,5.26857142857143,175,124
"209",18,6.8,5,256,450,0.0137867647058824,1.7578125,1.7578125,1.57839531319181,72,56,128,0.50457775592804,2,1.39130434782609,5.09782608695652,184,128
"210",18,10.04,6,280,503,0.0128776241679467,1.79642857142857,1.79642857142857,1.6767488848178,78,62,140,0.486261367797852,2,1.38613861386139,4.86633663366337,202,140
"211",18,10.82,7,293,537,0.0125531815419141,1.83276450511945,1.83276450511945,1.65323487697259,79,63,151,0.477178543806076,2.06338028169014,1.36915887850467,4.70560747663551,214,142
"212",18,13.04,8,312,602,0.0124082776815896,1.92948717948718,1.92948717948718,1.71626232879805,82,65,165,0.476327538490295,2.12244897959184,1.35652173913043,4.60434782608696,230,147
"213",18,16.52,9,323,640,0.0123069822894833,1.98142414860681,1.98142414860681,1.7455466850857,84,68,171,0.478856235742569,2.125,1.35146443514644,4.48117154811716,239,152
"214",18,19.41,10,337,696,0.0122933446375583,2.06528189910979,2.06528189910979,1.73467767414048,85,73,179,0.432312309741974,2.13291139240506,1.33730158730159,4.33730158730159,252,158
"215",18,19.98,11,341,722,0.0124547179575643,2.11730205278592,2.11730205278592,1.7696502766845,86,75,180,0.456926554441452,2.11801242236025,1.33725490196078,4.30588235294118,255,161
"216",18,21.5,12,349,753,0.0123999604782136,2.15759312320917,2.15759312320917,1.78717874239867,88,78,183,0.424523204565048,2.10240963855422,1.33716475095785,4.24521072796935,261,166
"217",19,1.25,1,132,163,0.018852648623641,1.23484848484848,1.23484848484848,1.33070044194863,42,28,62,0.615510582923889,1.88571428571429,1.46666666666667,7.02222222222222,90,70
"218",19,2.39,2,167,237,0.0170983334535748,1.41916167664671,1.41916167664671,1.40573239953255,51,38,78,0.59302282333374,1.87640449438202,1.43965517241379,6.43103448275862,116,89
"219",19,5.97,3,228,369,0.0142592163227452,1.61842105263158,1.61842105263158,1.55397105346665,68,53,107,0.494983851909637,1.88429752066116,1.425,5.475,160,121
"220",19,6.1,4,242,407,0.013956997359487,1.68181818181818,1.68181818181818,1.556038003989,70,53,119,0.52601283788681,1.96747967479675,1.40697674418605,5.23837209302326,172,123
"221",19,6.88,5,265,450,0.0128644939965695,1.69811320754717,1.69811320754717,1.54868764060272,73,55,137,0.512202441692352,2.0703125,1.38020833333333,4.97395833333333,192,128
"222",19,9.1,6,292,524,0.0123334745563244,1.79452054794521,1.79452054794521,1.64169879275224,78,60,154,0.498929262161255,2.11594202898551,1.36448598130841,4.80373831775701,214,138
"223",19,11.99,7,310,591,0.0123394926401503,1.90645161290323,1.90645161290323,1.65234747441388,79,65,166,0.493198841810226,2.15277777777778,1.34199134199134,4.59307359307359,231,144
"224",19,12.69,8,316,622,0.0124974884468555,1.96835443037975,1.96835443037975,1.6724496437582,80,67,169,0.478761076927185,2.14965986394558,1.33898305084746,4.54237288135593,236,147
"225",19,13.26,9,322,650,0.012577156014783,2.01863354037267,2.01863354037267,1.71514649978204,82,69,171,0.437969237565994,2.13245033112583,1.34166666666667,4.49166666666667,240,151
"226",19,16.5,10,332,690,0.0125577840061151,2.07831325301205,2.07831325301205,1.75707128910711,85,72,175,0.437548786401749,2.11464968152866,1.34412955465587,4.40080971659919,247,157
"227",19,19.98,11,341,722,0.0124547179575643,2.11730205278592,2.11730205278592,1.7696502766845,86,75,180,0.456926554441452,2.11801242236025,1.33725490196078,4.30588235294118,255,161
"228",19,21.5,12,349,753,0.0123999604782136,2.15759312320917,2.15759312320917,1.78717874239867,88,78,183,0.424523204565048,2.10240963855422,1.33716475095785,4.24521072796935,261,166
"229",20,1.52,1,120,123,0.0172268907563025,1.025,1.025,1.07664941419089,38,25,57,0.737590074539185,1.9047619047619,1.46341463414634,7.03658536585366,82,63
"230",20,3.74,2,207,278,0.013038788049341,1.34299516908213,1.34299516908213,1.35943614009503,61,46,100,0.607939481735229,1.93457943925234,1.41780821917808,5.79452054794521,146,107
"231",20,3.87,3,222,326,0.0132893074069545,1.46846846846847,1.46846846846847,1.40539526758753,62,47,113,0.596042335033417,2.03669724770642,1.3875,5.50625,160,109
"232",20,7.45,4,266,441,0.0125124131082423,1.65789473684211,1.65789473684211,1.60308949806578,76,59,131,0.533378601074219,1.97037037037037,1.4,5.06842105263158,190,135
"233",20,8.7,5,289,501,0.0120386389850058,1.73356401384083,1.73356401384083,1.6764434466609,81,64,144,0.494163393974304,1.99310344827586,1.38942307692308,4.875,208,145
"234",20,9.84,6,294,529,0.0122820459241717,1.79931972789116,1.79931972789116,1.6824529257263,81,65,148,0.488162904977798,2.01369863013699,1.38028169014085,4.80281690140845,213,146
"235",20,10.62,7,305,565,0.0121872303710095,1.85245901639344,1.85245901639344,1.66740309120944,82,65,158,0.498651385307312,2.07482993197279,1.3677130044843,4.69058295964126,223,147
"236",20,13.51,8,322,631,0.0122095160697355,1.95962732919255,1.95962732919255,1.67790924170827,83,69,170,0.451047420501709,2.11842105263158,1.34728033472803,4.4979079497908,239,152
"237",20,14.08,9,325,658,0.0124976258309592,2.02461538461538,2.02461538461538,1.72846272083923,84,71,170,0.41411417722702,2.09677419354839,1.34854771784232,4.46887966804979,241,155
"238",20,17.32,10,334,697,0.0125334915754077,2.08682634730539,2.08682634730539,1.76361202233854,86,74,174,0.431332051753998,2.0875,1.34677419354839,4.37903225806452,248,160
"239",20,20.8,11,343,727,0.0123949329105076,2.11953352769679,2.11953352769679,1.78112268408736,87,77,179,0.410857290029526,2.09146341463415,1.33984375,4.28515625,256,164
"240",20,21.5,12,349,753,0.0123999604782136,2.15759312320917,2.15759312320917,1.78717874239867,88,78,183,0.424523204565048,2.10240963855422,1.33716475095785,4.24521072796935,261,166
"241",21,2.22,1,171,214,0.0147230822153423,1.25146198830409,1.25146198830409,1.28872700047602,51,39,81,0.66843169927597,1.9,1.425,6.475,120,90
"242",21,2.92,2,204,282,0.0136192407997682,1.38235294117647,1.38235294117647,1.3530572721254,58,42,104,0.59000426530838,2.04,1.3972602739726,5.93835616438356,146,100
"243",21,4.17,3,233,356,0.0131715258250703,1.52789699570815,1.52789699570815,1.58235080272345,67,52,114,0.555394649505615,1.95798319327731,1.40361445783133,5.58433734939759,166,119
"244",21,5.69,4,260,407,0.0120879120879121,1.56538461538462,1.56538461538462,1.60253675598362,75,57,128,0.538107693195343,1.96969696969697,1.40540540540541,5.22702702702703,185,132
"245",21,6.26,5,269,450,0.0124840481606836,1.6728624535316,1.6728624535316,1.70538052050991,76,59,134,0.534451842308044,1.99259259259259,1.39378238341969,5.13471502590674,193,135
"246",21,9.15,6,289,527,0.0126633986928105,1.82352941176471,1.82352941176471,1.70500477314527,78,64,147,0.496651411056519,2.03521126760563,1.3696682464455,4.88625592417062,211,142
"247",21,12.73,7,314,613,0.0124743086221282,1.95222929936306,1.95222929936306,1.74400452757147,84,72,158,0.491360425949097,2.01282051282051,1.36521739130435,4.6,230,156
"248",21,15.97,8,325,653,0.0124026590693257,2.00923076923077,2.00923076923077,1.78015775802988,86,75,164,0.483452498912811,2.01863354037267,1.35983263598326,4.48953974895398,239,161
"249",21,16.75,9,333,682,0.0123376388436629,2.04804804804805,2.04804804804805,1.76480654272335,87,75,171,0.459800958633423,2.05555555555556,1.35365853658537,4.40650406504065,246,162
"250",21,20.23,10,343,713,0.0121562409424923,2.07871720116618,2.07871720116618,1.78201359734658,88,78,177,0.421617984771729,2.06626506024096,1.34509803921569,4.30980392156863,255,166
"251",21,21.37,11,346,731,0.0122476334087292,2.11271676300578,2.11271676300578,1.78827717377754,88,78,180,0.458441913127899,2.08433734939759,1.34108527131783,4.27519379844961,258,166
"252",21,21.5,12,349,753,0.0123999604782136,2.15759312320917,2.15759312320917,1.78717874239867,88,78,183,0.424523204565048,2.10240963855422,1.33716475095785,4.24521072796935,261,166
"253",22,3.48,1,144,158,0.0153457653457653,1.09722222222222,1.09722222222222,1.24917081106252,45,30,69,0.688811957836151,1.92,1.45454545454545,6.97979797979798,99,75
"254",22,4.18,2,190,240,0.0133667502088555,1.26315789473684,1.26315789473684,1.31420919057441,57,35,98,0.608758687973022,2.06521739130435,1.42857142857143,6.11278195488722,133,92
"255",22,5.43,3,216,311,0.0133936261843239,1.43981481481481,1.43981481481481,1.49728394595569,64,44,108,0.595051765441895,2,1.42105263157895,5.76315789473684,152,108
"256",22,8.67,4,249,378,0.0122425184609405,1.51807228915663,1.51807228915663,1.62660396067991,72,52,125,0.56823718547821,2.00806451612903,1.40677966101695,5.25988700564972,177,124
"257",22,8.8,5,254,416,0.0129469982260123,1.63779527559055,1.63779527559055,1.60338443709583,72,53,129,0.540744066238403,2.032,1.3956043956044,5.15934065934066,182,125
"258",22,9.58,6,272,455,0.0123453440416757,1.67279411764706,1.67279411764706,1.57866443256513,75,55,142,0.520509541034698,2.09230769230769,1.38071065989848,4.90862944162437,197,130
"259",22,11.8,7,291,525,0.0124422324920014,1.80412371134021,1.80412371134021,1.66089210658777,78,59,154,0.50181770324707,2.12408759124088,1.36619718309859,4.80281690140845,213,137
"260",22,12.37,8,299,559,0.0125474175663846,1.8695652173913,1.8695652173913,1.7417620115198,79,61,159,0.47050866484642,2.13571428571429,1.35909090909091,4.73181818181818,220,140
"261",22,13.89,9,312,595,0.0122639953829664,1.90705128205128,1.90705128205128,1.76369768508242,82,66,164,0.442162305116653,2.10810810810811,1.35652173913043,4.61739130434783,230,148
"262",22,17.47,10,334,679,0.0122098146050242,2.03293413173653,2.03293413173653,1.78737186226138,87,73,174,0.452369838953018,2.0875,1.35222672064777,4.41295546558704,247,160
"263",22,20.36,11,346,735,0.0123146519225936,2.1242774566474,2.1242774566474,1.78126103555556,88,78,180,0.429825574159622,2.08433734939759,1.34108527131783,4.27906976744186,258,166
"264",22,21.5,12,349,753,0.0123999604782136,2.15759312320917,2.15759312320917,1.78717874239867,88,78,183,0.424523204565048,2.10240963855422,1.33716475095785,4.24521072796935,261,166
"265",23,1.14,1,114,141,0.0218910107126223,1.23684210526316,1.23684210526316,1.17486110561291,37,25,52,0.668024718761444,1.83870967741935,1.48051948051948,7.28571428571429,77,62
"266",23,2.39,2,167,237,0.0170983334535748,1.41916167664671,1.41916167664671,1.40573239953255,51,38,78,0.59302282333374,1.87640449438202,1.43965517241379,6.43103448275862,116,89
"267",23,5.63,3,214,316,0.0138651221973586,1.47663551401869,1.47663551401869,1.60297535300125,62,48,104,0.572859883308411,1.94545454545455,1.40789473684211,5.69736842105263,152,110
"268",23,6.2,4,231,367,0.0138151703369095,1.58874458874459,1.58874458874459,1.74705013615447,67,52,112,0.545352637767792,1.94117647058824,1.40853658536585,5.44512195121951,164,119
"269",23,6.98,5,251,409,0.0130358565737052,1.62948207171315,1.62948207171315,1.72906188773772,71,52,128,0.533339142799377,2.04065040650406,1.39444444444444,5.13888888888889,180,123
"270",23,7.11,6,257,441,0.0134058852140078,1.715953307393,1.715953307393,1.69836389161244,71,53,133,0.517690658569336,2.07258064516129,1.38172043010753,5.03225806451613,186,124
"271",23,10.59,7,272,482,0.013077924896896,1.77205882352941,1.77205882352941,1.72555649826327,74,57,141,0.488122195005417,2.0763358778626,1.37373737373737,4.85353535353535,198,131
"272",23,13.48,8,297,549,0.0124897624897625,1.84848484848485,1.84848484848485,1.70326318753999,78,62,157,0.469439417123795,2.12142857142857,1.35616438356164,4.63013698630137,219,140
"273",23,15,9,311,585,0.012135670573592,1.88102893890675,1.88102893890675,1.73573331216245,81,67,163,0.457977890968323,2.10135135135135,1.35217391304348,4.54347826086957,230,148
"274",23,15.7,10,318,615,0.0122016546634129,1.93396226415094,1.93396226415094,1.72929088101817,82,68,168,0.434868156909943,2.12,1.34745762711864,4.49576271186441,236,150
"275",23,19.28,11,338,695,0.0122030446157358,2.05621301775148,2.05621301775148,1.754077781403,87,76,175,0.441011279821396,2.07361963190184,1.34661354581673,4.31075697211155,251,163
"276",23,21.5,12,349,753,0.0123999604782136,2.15759312320917,2.15759312320917,1.78717874239867,88,78,183,0.424523204565048,2.10240963855422,1.33716475095785,4.24521072796935,261,166
"277",24,1.52,1,120,123,0.0172268907563025,1.025,1.025,1.07664941419089,38,25,57,0.737590074539185,1.9047619047619,1.46341463414634,7.03658536585366,82,63
"278",24,3.74,2,207,278,0.013038788049341,1.34299516908213,1.34299516908213,1.35943614009503,61,46,100,0.607939481735229,1.93457943925234,1.41780821917808,5.79452054794521,146,107
"279",24,3.87,3,222,326,0.0132893074069545,1.46846846846847,1.46846846846847,1.40539526758753,62,47,113,0.596042335033417,2.03669724770642,1.3875,5.50625,160,109
"280",24,6.76,4,261,432,0.0127320954907162,1.6551724137931,1.6551724137931,1.55347285503313,71,56,134,0.553487181663513,2.05511811023622,1.37368421052632,5.11052631578947,190,127
"281",24,8.01,5,282,488,0.0123167007395068,1.73049645390071,1.73049645390071,1.60567530573858,76,61,145,0.49079555273056,2.05839416058394,1.36893203883495,4.94174757281553,206,137
"282",24,11.49,6,294,523,0.0121427410554666,1.77891156462585,1.77891156462585,1.619756732357,78,64,152,0.482069551944733,2.07042253521127,1.36111111111111,4.78703703703704,216,142
"283",24,15.07,7,317,609,0.0121590863714411,1.9211356466877,1.9211356466877,1.70012022315225,83,72,162,0.468284964561462,2.04516129032258,1.35470085470085,4.52991452991453,234,155
"284",24,15.85,8,327,640,0.0120072794131442,1.95718654434251,1.95718654434251,1.69208171998714,84,72,171,0.437047123908997,2.09615384615385,1.34567901234568,4.44855967078189,243,156
"285",24,16.42,9,330,669,0.0123238463663996,2.02727272727273,2.02727272727273,1.74191773468784,85,74,171,0.437995046377182,2.07547169811321,1.3469387755102,4.42040816326531,245,159
"286",24,17.56,10,334,689,0.0123896351441262,2.06287425149701,2.06287425149701,1.74554213299748,85,74,175,0.421163141727448,2.10062893081761,1.34136546184739,4.36947791164659,249,159
"287",24,20.8,11,343,727,0.0123949329105076,2.11953352769679,2.11953352769679,1.78112268408736,87,77,179,0.410857290029526,2.09146341463415,1.33984375,4.28515625,256,164
"288",24,21.5,12,349,753,0.0123999604782136,2.15759312320917,2.15759312320917,1.78717874239867,88,78,183,0.424523204565048,2.10240963855422,1.33716475095785,4.24521072796935,261,166
"289",25,1.14,1,114,141,0.0218910107126223,1.23684210526316,1.23684210526316,1.17486110561291,37,25,52,0.668024718761444,1.83870967741935,1.48051948051948,7.28571428571429,77,62
"290",25,3.36,2,187,271,0.0155827726985222,1.44919786096257,1.44919786096257,1.33889892129921,54,40,93,0.610401570796967,1.98936170212766,1.40601503759399,6.09774436090226,133,94
"291",25,6.84,3,221,338,0.013903743315508,1.52941176470588,1.52941176470588,1.43863635301386,63,46,112,0.599983334541321,2.02752293577982,1.39873417721519,5.59493670886076,158,109
"292",25,7.54,4,242,385,0.013202565069785,1.59090909090909,1.59090909090909,1.4835536703905,67,48,127,0.547913610935211,2.10434782608696,1.38285714285714,5.32571428571429,175,115
"293",25,9.06,5,260,424,0.0125928125928126,1.63076923076923,1.63076923076923,1.52342558214793,72,53,135,0.514835059642792,2.08,1.38297872340426,5.11702127659574,188,125
"294",25,9.63,6,269,463,0.0128446984408811,1.72118959107807,1.72118959107807,1.64026336857755,73,56,140,0.492011368274689,2.08527131782946,1.37244897959184,5.03571428571429,196,129
"295",25,12.52,7,291,539,0.0127740253584548,1.85223367697595,1.85223367697595,1.67417912341402,76,62,153,0.483844578266144,2.10869565217391,1.35348837209302,4.75348837209302,215,138
"296",25,15.76,8,305,579,0.0124892148403796,1.8983606557377,1.8983606557377,1.73078767236265,78,67,160,0.469912707805634,2.10344827586207,1.34361233480176,4.59471365638767,227,145
"297",25,15.89,9,309,608,0.0127768671457992,1.96763754045307,1.96763754045307,1.76046140658743,78,67,164,0.457552015781403,2.13103448275862,1.33766233766234,4.54545454545455,231,145
"298",25,19.47,10,332,689,0.0125395843191497,2.07530120481928,2.07530120481928,1.78517932361576,84,75,173,0.442756980657578,2.08805031446541,1.33870967741935,4.375,248,159
"299",25,20.72,11,342,727,0.0124676304642349,2.12573099415205,2.12573099415205,1.80164285871487,87,78,177,0.454396992921829,2.07272727272727,1.34117647058824,4.30980392156863,255,165
"300",25,21.5,12,349,753,0.0123999604782136,2.15759312320917,2.15759312320917,1.78717874239867,88,78,183,0.424523204565048,2.10240963855422,1.33716475095785,4.24521072796935,261,166
"301",26,1.52,1,120,123,0.0172268907563025,1.025,1.025,1.07664941419089,38,25,57,0.737590074539185,1.9047619047619,1.46341463414634,7.03658536585366,82,63
"302",26,2.09,2,177,224,0.0143810991268618,1.26553672316384,1.26553672316384,1.5050678879184,54,43,80,0.661063075065613,1.82474226804124,1.4390243902439,6,123,97
"303",26,5.57,3,209,290,0.0133419212366581,1.38755980861244,1.38755980861244,1.59719775129047,61,48,100,0.569702684879303,1.91743119266055,1.41216216216216,5.68918918918919,148,109
"304",26,6.27,4,236,345,0.0124413992066354,1.46186440677966,1.46186440677966,1.56158695471631,66,49,121,0.547611892223358,2.05217391304348,1.38823529411765,5.42941176470588,170,115
"305",26,7.41,5,241,385,0.0133125864453665,1.59751037344398,1.59751037344398,1.61016457371945,67,52,122,0.516849398612976,2.02521008403361,1.38505747126437,5.33333333333333,174,119
"306",26,9.63,6,269,463,0.0128446984408811,1.72118959107807,1.72118959107807,1.64026336857755,73,56,140,0.492011368274689,2.08527131782946,1.37244897959184,5.03571428571429,196,129
"307",26,12.87,7,285,506,0.0125030887076847,1.77543859649123,1.77543859649123,1.72233964526467,76,61,148,0.47570264339447,2.08029197080292,1.36363636363636,4.83732057416268,209,137
"308",26,14.12,8,302,558,0.012276957602693,1.8476821192053,1.8476821192053,1.80313109815063,81,67,154,0.494223862886429,2.04054054054054,1.36651583710407,4.73303167420814,221,148
"309",26,14.25,9,306,586,0.0125575913425479,1.91503267973856,1.91503267973856,1.80340285923188,81,67,158,0.446567565202713,2.06756756756757,1.36,4.68,225,148
"310",26,17.14,10,321,648,0.0126168224299065,2.01869158878505,2.01869158878505,1.77874522317641,82,71,168,0.431686788797379,2.09803921568627,1.34309623430962,4.5020920502092,239,153
"311",26,17.92,11,329,675,0.0125101934909927,2.0516717325228,2.0516717325228,1.76028004046815,83,71,175,0.41419917345047,2.13636363636364,1.33739837398374,4.41869918699187,246,154
"312",26,21.5,12,349,753,0.0123999604782136,2.15759312320917,2.15759312320917,1.78717874239867,88,78,183,0.424523204565048,2.10240963855422,1.33716475095785,4.24521072796935,261,166
"313",27,1.14,1,114,141,0.0218910107126223,1.23684210526316,1.23684210526316,1.17486110561291,37,25,52,0.668024718761444,1.83870967741935,1.48051948051948,7.28571428571429,77,62
"314",27,4.03,2,189,274,0.0154227175503771,1.44973544973545,1.44973544973545,1.34873938328823,55,39,95,0.562709808349609,2.01063829787234,1.41044776119403,6.08955223880597,134,94
"315",27,4.16,3,208,320,0.0148643626904496,1.53846153846154,1.53846153846154,1.41551956968949,58,43,107,0.529843747615814,2.05940594059406,1.38666666666667,5.71333333333333,150,101
"316",27,7.74,4,257,434,0.013193093385214,1.68871595330739,1.68871595330739,1.53898052644293,71,56,130,0.528236448764801,2.02362204724409,1.38172043010753,5.10215053763441,186,127
"317",27,8.31,5,273,481,0.0129551820728291,1.76190476190476,1.76190476190476,1.67377385793678,74,60,139,0.502980172634125,2.03731343283582,1.37185929648241,4.89949748743719,199,134
"318",27,9.09,6,282,513,0.012947679260998,1.81914893617021,1.81914893617021,1.63891103431085,75,61,146,0.511655986309052,2.07352941176471,1.36231884057971,4.79227053140097,207,136
"319",27,11.31,7,301,578,0.0128017718715393,1.9202657807309,1.9202657807309,1.6917625600597,78,65,158,0.490485936403275,2.10489510489511,1.34977578475336,4.66816143497758,223,143
"320",27,14.55,8,313,620,0.0126976325059392,1.98083067092652,1.98083067092652,1.73659854324103,81,68,164,0.477297127246857,2.1006711409396,1.34913793103448,4.54310344827586,232,149
"321",27,16.07,9,321,655,0.0127531152647975,2.0404984423676,2.0404984423676,1.74443976285857,83,72,166,0.460255235433578,2.07096774193548,1.34873949579832,4.47058823529412,238,155
"322",27,19.55,10,331,687,0.0125789618236748,2.07552870090634,2.07552870090634,1.76351855952467,84,75,172,0.410711258649826,2.08176100628931,1.34008097165992,4.37651821862348,247,159
"323",27,20.25,11,339,717,0.0125150547206367,2.11504424778761,2.11504424778761,1.7706587744849,85,76,178,0.435257375240326,2.1055900621118,1.33464566929134,4.30708661417323,254,161
"324",27,21.5,12,349,753,0.0123999604782136,2.15759312320917,2.15759312320917,1.78717874239867,88,78,183,0.424523204565048,2.10240963855422,1.33716475095785,4.24521072796935,261,166
"325",28,3.58,1,171,218,0.0149982800137599,1.27485380116959,1.27485380116959,1.32365427157769,51,39,81,0.601738095283508,1.9,1.425,6.25833333333333,120,90
"326",28,4.72,2,198,293,0.0150233297441419,1.47979797979798,1.47979797979798,1.427783722339,61,46,91,0.538765668869019,1.85046728971963,1.44525547445255,5.91970802919708,137,107
"327",28,5.42,3,226,349,0.0137266470009833,1.54424778761062,1.54424778761062,1.47544786538484,65,50,111,0.521769165992737,1.96521739130435,1.40372670807453,5.52795031055901,161,115
"328",28,7.64,4,264,440,0.0126742712294043,1.66666666666667,1.66666666666667,1.58903084029444,72,57,135,0.514907002449036,2.04651162790698,1.375,5.09895833333333,192,129
"329",28,8.89,5,283,498,0.0124802646417563,1.75971731448763,1.75971731448763,1.69121672758251,77,62,144,0.508907079696655,2.03597122302158,1.37378640776699,4.89320388349515,206,139
"330",28,10.41,6,298,539,0.0121799652000994,1.80872483221477,1.80872483221477,1.70968414765228,82,66,150,0.490998923778534,2.01351351351351,1.37962962962963,4.76388888888889,216,148
"331",28,10.98,7,305,571,0.0123166522864538,1.87213114754098,1.87213114754098,1.7491884978817,83,68,154,0.487766832113266,2.01986754966887,1.37387387387387,4.72072072072072,222,151
"332",28,14.46,8,314,605,0.0123115117722472,1.92675159235669,1.92675159235669,1.77606057422977,84,71,159,0.483409613370895,2.0258064516129,1.36521739130435,4.60434782608696,230,155
"333",28,17.35,9,328,666,0.0124188856567465,2.03048780487805,2.03048780487805,1.76537920449921,85,75,168,0.483254641294479,2.05,1.34979423868313,4.43621399176955,243,160
"334",28,17.48,10,332,690,0.0125577840061151,2.07831325301205,2.07831325301205,1.7646184307219,85,75,172,0.459378302097321,2.075,1.34412955465587,4.39271255060729,247,160
"335",28,20.72,11,342,727,0.0124676304642349,2.12573099415205,2.12573099415205,1.80164285871487,87,78,177,0.454396992921829,2.07272727272727,1.34117647058824,4.30980392156863,255,165
"336",28,21.5,12,349,753,0.0123999604782136,2.15759312320917,2.15759312320917,1.78717874239867,88,78,183,0.424523204565048,2.10240963855422,1.33716475095785,4.24521072796935,261,166
"337",29,0.78,1,137,147,0.0157793044224989,1.07299270072993,1.07299270072993,1.13376587282185,42,25,70,0.767758846282959,2.04477611940298,1.44210526315789,6.95789473684211,95,67
"338",29,3,2,199,277,0.0140601999898482,1.39195979899497,1.39195979899497,1.30907498832681,55,42,102,0.63313090801239,2.05154639175258,1.38194444444444,5.92361111111111,144,97
"339",29,3.7,3,222,333,0.0135746606334842,1.5,1.5,1.36279663954094,60,45,117,0.581793546676636,2.11428571428571,1.37037037037037,5.61111111111111,162,105
"340",29,7.18,4,252,392,0.0123948649845064,1.55555555555556,1.55555555555556,1.45637429930732,69,49,134,0.55366575717926,2.13559322033898,1.37704918032787,5.2568306010929,183,118
"341",29,8.32,5,259,428,0.0128101523450361,1.65250965250965,1.65250965250965,1.50165658757007,69,50,140,0.532887637615204,2.17647058823529,1.36315789473684,5.12105263157895,190,119
"342",29,11.9,6,292,529,0.0124511603822436,1.81164383561644,1.81164383561644,1.64760016935103,77,62,153,0.467885404825211,2.10071942446043,1.35813953488372,4.75348837209302,215,139
"343",29,13.15,7,308,575,0.0121621049959812,1.86688311688312,1.86688311688312,1.69154598891485,81,65,162,0.506161153316498,2.10958904109589,1.3568281938326,4.61674008810573,227,146
"344",29,13.28,8,311,598,0.012405352141894,1.92282958199357,1.92282958199357,1.68447086147826,81,65,165,0.489261835813522,2.13013698630137,1.35217391304348,4.57826086956522,230,146
"345",29,14.8,9,322,633,0.0122482150113194,1.96583850931677,1.96583850931677,1.7112359003121,84,69,169,0.45213371515274,2.10457516339869,1.35294117647059,4.49579831932773,238,153
"346",29,15.37,10,327,660,0.012382506894805,2.01834862385321,2.01834862385321,1.75016749040946,85,71,171,0.442776650190353,2.09615384615385,1.35123966942149,4.47107438016529,242,156
"347",29,18.26,11,340,716,0.012424084678119,2.10588235294118,2.10588235294118,1.75191769590306,86,75,179,0.429503411054611,2.11180124223602,1.33858267716535,4.32677165354331,254,161
"348",29,21.5,12,349,753,0.0123999604782136,2.15759312320917,2.15759312320917,1.78717874239867,88,78,183,0.424523204565048,2.10240963855422,1.33716475095785,4.24521072796935,261,166
"349",30,1.14,1,114,141,0.0218910107126223,1.23684210526316,1.23684210526316,1.17486110561291,37,25,52,0.668024718761444,1.83870967741935,1.48051948051948,7.28571428571429,77,62
"350",30,1.27,2,147,201,0.0187307799832262,1.36734693877551,1.36734693877551,1.24949020263686,43,31,73,0.598648548126221,1.98648648648649,1.41346153846154,6.5,104,74
"351",30,3.49,3,206,313,0.0148235851290552,1.51941747572816,1.51941747572816,1.3907744490086,58,41,107,0.593386650085449,2.08080808080808,1.39189189189189,5.73648648648649,148,99
"352",30,6.38,4,245,412,0.0137838742054199,1.68163265306122,1.68163265306122,1.50802515614799,66,51,128,0.547268271446228,2.09401709401709,1.36871508379888,5.26815642458101,179,117
"353",30,9.62,5,264,462,0.0133079847908745,1.75,1.75,1.61451474823688,70,56,138,0.494195222854614,2.0952380952381,1.36082474226804,5.00515463917526,194,126
"354",30,10.19,6,274,502,0.0134221010133419,1.83211678832117,1.83211678832117,1.73556900175092,72,58,144,0.492135107517242,2.10769230769231,1.35643564356436,4.88613861386139,202,130
"355",30,13.77,7,306,590,0.0126433086895961,1.9281045751634,1.9281045751634,1.75953913283549,80,67,159,0.490710973739624,2.08163265306122,1.35398230088496,4.62389380530973,226,147
"356",30,14.55,8,313,620,0.0126976325059392,1.98083067092652,1.98083067092652,1.73659854324103,81,68,164,0.477297127246857,2.1006711409396,1.34913793103448,4.54310344827586,232,149
"357",30,16.07,9,321,655,0.0127531152647975,2.0404984423676,2.0404984423676,1.74443976285857,83,72,166,0.460255235433578,2.07096774193548,1.34873949579832,4.47058823529412,238,155
"358",30,17.32,10,334,697,0.0125334915754077,2.08682634730539,2.08682634730539,1.76361202233854,86,74,174,0.431332051753998,2.0875,1.34677419354839,4.37903225806452,248,160
"359",30,18.02,11,340,723,0.0125455491931286,2.12647058823529,2.12647058823529,1.76872581738239,87,75,178,0.414171606302261,2.09876543209877,1.34387351778656,4.33596837944664,253,162
"360",30,21.5,12,349,753,0.0123999604782136,2.15759312320917,2.15759312320917,1.78717874239867,88,78,183,0.424523204565048,2.10240963855422,1.33716475095785,4.24521072796935,261,166
"361",31,2.89,1,163,202,0.015299553131864,1.23926380368098,1.23926380368098,1.32935663673885,48,35,80,0.611067533493042,1.96385542168675,1.41739130434783,6.6,115,83
"362",31,4.14,2,200,287,0.0144221105527638,1.435,1.435,1.41557906602171,58,42,100,0.558917820453644,2,1.40845070422535,6.06338028169014,142,100
"363",31,6.36,3,250,405,0.0130120481927711,1.62,1.62,1.5543994154776,70,56,124,0.535427570343018,1.98412698412698,1.38888888888889,5.34444444444444,180,126
"364",31,7.14,4,266,445,0.0126259043836005,1.67293233082707,1.67293233082707,1.54944148446409,71,56,139,0.53541225194931,2.09448818897638,1.36410256410256,5.11794871794872,195,127
"365",31,10.72,5,296,541,0.0123912047640861,1.8277027027027,1.8277027027027,1.64671696973882,78,65,153,0.510535299777985,2.06993006993007,1.35779816513761,4.74770642201835,218,143
"366",31,11.86,6,303,567,0.012392629991476,1.87128712871287,1.87128712871287,1.65082711792717,78,65,160,0.505101263523102,2.11888111888112,1.34666666666667,4.66222222222222,225,143
"367",31,15.1,7,314,609,0.0123929101971877,1.93949044585987,1.93949044585987,1.70029944755005,81,68,165,0.483002632856369,2.10738255033557,1.34763948497854,4.55364806866953,233,149
"368",31,16.62,8,326,647,0.0122133081642284,1.98466257668712,1.98466257668712,1.71630903678651,85,72,169,0.462602376937866,2.07643312101911,1.35269709543568,4.46058091286307,241,157
"369",31,17.32,9,334,675,0.0121378863893834,2.02095808383234,2.02095808383234,1.73600816858632,86,73,175,0.462692975997925,2.10062893081761,1.34677419354839,4.39516129032258,248,159
"370",31,17.89,10,337,701,0.012381658895012,2.08011869436202,2.08011869436202,1.77079899429915,87,75,175,0.463083118200302,2.08024691358025,1.348,4.368,250,162
"371",31,18.02,11,340,723,0.0125455491931286,2.12647058823529,2.12647058823529,1.76872581738239,87,75,178,0.414171606302261,2.09876543209877,1.34387351778656,4.33596837944664,253,162
"372",31,21.5,12,349,753,0.0123999604782136,2.15759312320917,2.15759312320917,1.78717874239867,88,78,183,0.424523204565048,2.10240963855422,1.33716475095785,4.24521072796935,261,166
"373",32,0.7,1,144,151,0.0146658896658897,1.04861111111111,1.04861111111111,1.16294760117179,43,26,75,0.720012247562408,2.08695652173913,1.42574257425743,6.81188118811881,101,69
"374",32,1.84,2,163,220,0.0166628796485647,1.34969325153374,1.34969325153374,1.28996523405513,47,31,85,0.602479338645935,2.08974358974359,1.4051724137931,6.36206896551724,116,78
"375",32,2.41,3,193,286,0.0154360967184801,1.48186528497409,1.48186528497409,1.53404226275815,56,42,95,0.524188160896301,1.96938775510204,1.40875912408759,5.89051094890511,137,98
"376",32,3.66,4,220,356,0.0147779161477792,1.61818181818182,1.61818181818182,1.65353572586575,63,50,107,0.519584059715271,1.94690265486726,1.40127388535032,5.61146496815287,157,113
"377",32,4.44,5,240,398,0.0138772663877266,1.65833333333333,1.65833333333333,1.61296579569596,67,50,123,0.489094376564026,2.05128205128205,1.38728323699422,5.27167630057803,173,117
"378",32,4.57,6,246,429,0.0142359382777501,1.74390243902439,1.74390243902439,1.59976003713526,67,51,128,0.485356420278549,2.08474576271186,1.37430167597765,5.16759776536313,179,118
"379",32,8.05,7,263,472,0.0136998229472034,1.79467680608365,1.79467680608365,1.63248570853912,70,54,139,0.482128381729126,2.12096774193548,1.36269430051813,4.96891191709845,193,124
"380",32,11.29,8,283,519,0.0130065408615894,1.8339222614841,1.8339222614841,1.71241960951604,76,59,148,0.452316761016846,2.0962962962963,1.36714975845411,4.77777777777778,207,135
"381",32,12.81,9,299,554,0.0124351866400305,1.85284280936455,1.85284280936455,1.74677394819921,80,64,155,0.469439536333084,2.07638888888889,1.36529680365297,4.67579908675799,219,144
"382",32,15.03,10,315,616,0.0124557678697806,1.95555555555556,1.95555555555556,1.77783938411692,82,67,166,0.439757138490677,2.11409395973154,1.3519313304721,4.57510729613734,233,149
"383",32,17.92,11,329,675,0.0125101934909927,2.0516717325228,2.0516717325228,1.76028004046815,83,71,175,0.41419917345047,2.13636363636364,1.33739837398374,4.41869918699187,246,154
"384",32,21.5,12,349,753,0.0123999604782136,2.15759312320917,2.15759312320917,1.78717874239867,88,78,183,0.424523204565048,2.10240963855422,1.33716475095785,4.24521072796935,261,166
"385",33,3.48,1,144,158,0.0153457653457653,1.09722222222222,1.09722222222222,1.24917081106252,45,30,69,0.688811957836151,1.92,1.45454545454545,6.97979797979798,99,75
"386",33,6.37,2,206,286,0.0135448733128108,1.38834951456311,1.38834951456311,1.40582375343957,61,45,100,0.597541451454163,1.94339622641509,1.42068965517241,5.81379310344828,145,106
"387",33,9.95,3,253,401,0.0125792082313821,1.58498023715415,1.58498023715415,1.54104905079936,72,59,122,0.547403335571289,1.93129770992366,1.39779005524862,5.22099447513812,181,131
"388",33,10.73,4,272,449,0.0121825482960712,1.65073529411765,1.65073529411765,1.54460937813648,75,63,134,0.560701549053192,1.97101449275362,1.38071065989848,4.9746192893401,197,138
"389",33,12.95,5,296,534,0.0122308749427393,1.80405405405405,1.80405405405405,1.62478975288414,78,67,151,0.517725348472595,2.04137931034483,1.35779816513761,4.74311926605505,218,145
"390",33,13.08,6,300,560,0.0124860646599777,1.86666666666667,1.86666666666667,1.62781340016915,78,67,155,0.497949630022049,2.06896551724138,1.35135135135135,4.68918918918919,222,145
"391",33,14.22,7,306,584,0.0125147326690239,1.90849673202614,1.90849673202614,1.63601807183543,78,67,161,0.469068199396133,2.11034482758621,1.34210526315789,4.60964912280702,228,145
"392",33,15.74,8,316,620,0.0124573035965441,1.9620253164557,1.9620253164557,1.66002155777295,81,70,165,0.439062178134918,2.09271523178808,1.34468085106383,4.52765957446809,235,151
"393",33,16.99,9,331,662,0.0121212121212121,2,2,1.69714555365856,84,72,175,0.447630763053894,2.12179487179487,1.34008097165992,4.39676113360324,247,156
"394",33,17.56,10,334,689,0.0123896351441262,2.06287425149701,2.06287425149701,1.74554213299748,85,74,175,0.421163141727448,2.10062893081761,1.34136546184739,4.36947791164659,249,159
"395",33,20.8,11,343,727,0.0123949329105076,2.11953352769679,2.11953352769679,1.78112268408736,87,77,179,0.410857290029526,2.09146341463415,1.33984375,4.28515625,256,164
"396",33,21.5,12,349,753,0.0123999604782136,2.15759312320917,2.15759312320917,1.78717874239867,88,78,183,0.424523204565048,2.10240963855422,1.33716475095785,4.24521072796935,261,166
"397",34,0.57,1,142,160,0.0159824193387274,1.12676056338028,1.12676056338028,1.50917260456006,45,31,66,0.703574180603027,1.86842105263158,1.4639175257732,6.31958762886598,97,76
"398",34,3.46,2,206,299,0.014160549372484,1.45145631067961,1.45145631067961,1.62684052929615,62,46,98,0.565497040748596,1.90740740740741,1.43055555555556,5.72222222222222,144,108
"399",34,7.04,3,255,412,0.0127219391693685,1.6156862745098,1.6156862745098,1.66418777980439,73,59,123,0.513932704925537,1.93181818181818,1.4010989010989,5.15934065934066,182,132
"400",34,7.17,4,267,447,0.0125876488975247,1.67415730337079,1.67415730337079,1.68335948407212,74,59,134,0.487473040819168,2.00751879699248,1.38341968911917,5,193,133
"401",34,7.87,5,277,487,0.0127400198817559,1.75812274368231,1.75812274368231,1.66068873405454,75,62,140,0.488425970077515,2.02189781021898,1.37128712871287,4.87623762376238,202,137
"402",34,8.65,6,286,520,0.0127591706539075,1.81818181818182,1.81818181818182,1.62783356190464,76,64,146,0.472058027982712,2.04285714285714,1.36190476190476,4.77142857142857,210,140
"403",34,12.13,7,297,557,0.0126717626717627,1.87542087542088,1.87542087542088,1.64066430786799,77,67,153,0.467418074607849,2.0625,1.35,4.65,220,144
"404",34,14.35,8,315,625,0.0126377514912547,1.98412698412698,1.98412698412698,1.70248896850995,80,70,165,0.460494041442871,2.1,1.34042553191489,4.53617021276596,235,150
"405",34,15.6,9,327,662,0.0124200296429711,2.02446483180428,2.02446483180428,1.72501732696882,83,72,172,0.457340002059937,2.10967741935484,1.34016393442623,4.44262295081967,244,155
"406",34,18.84,10,338,704,0.0123610696539252,2.08284023668639,2.08284023668639,1.76292153152848,86,75,177,0.457429736852646,2.09937888198758,1.34126984126984,4.34126984126984,252,161
"407",34,19.98,11,341,722,0.0124547179575643,2.11730205278592,2.11730205278592,1.7696502766845,86,75,180,0.456926554441452,2.11801242236025,1.33725490196078,4.30588235294118,255,161
"408",34,21.5,12,349,753,0.0123999604782136,2.15759312320917,2.15759312320917,1.78717874239867,88,78,183,0.424523204565048,2.10240963855422,1.33716475095785,4.24521072796935,261,166
"409",35,3.48,1,144,158,0.0153457653457653,1.09722222222222,1.09722222222222,1.24917081106252,45,30,69,0.688811957836151,1.92,1.45454545454545,6.97979797979798,99,75
"410",35,5.7,2,211,290,0.0130895960279847,1.37440758293839,1.37440758293839,1.39450721028946,61,45,105,0.627865612506866,1.99056603773585,1.40666666666667,5.81333333333333,150,106
"411",35,7.22,3,232,338,0.0126138229586505,1.45689655172414,1.45689655172414,1.42781413332648,66,51,115,0.540247142314911,1.98290598290598,1.39759036144578,5.46987951807229,166,117
"412",35,7.92,4,255,389,0.0120117338273892,1.52549019607843,1.52549019607843,1.47935052809714,72,52,131,0.538877606391907,2.05645161290323,1.39344262295082,5.22404371584699,183,124
"413",35,8.7,5,270,433,0.01192344761118,1.6037037037037,1.6037037037037,1.49032030588674,73,54,143,0.524497449398041,2.1259842519685,1.37055837563452,5.05583756345178,197,127
"414",35,12.28,6,298,533,0.012044381171898,1.78859060402685,1.78859060402685,1.6426416878334,80,65,153,0.490515321493149,2.0551724137931,1.36697247706422,4.73853211009174,218,145
"415",35,13.42,7,303,564,0.0123270605206216,1.86138613861386,1.86138613861386,1.67057020584046,80,66,157,0.462295979261398,2.07534246575342,1.35874439461883,4.65919282511211,223,146
"416",35,16.66,8,316,604,0.0121358247940526,1.91139240506329,1.91139240506329,1.73431598193066,82,70,164,0.438214063644409,2.07894736842105,1.35042735042735,4.53418803418803,234,152
"417",35,17.23,9,321,633,0.0123247663551402,1.97196261682243,1.97196261682243,1.7831813386557,83,72,166,0.429764747619629,2.07096774193548,1.34873949579832,4.49159663865546,238,155
"418",35,20.12,10,336,693,0.0123134328358209,2.0625,2.0625,1.76942929643608,85,76,175,0.447752118110657,2.08695652173913,1.33864541832669,4.33864541832669,251,161
"419",35,20.25,11,339,717,0.0125150547206367,2.11504424778761,2.11504424778761,1.7706587744849,85,76,178,0.435257375240326,2.1055900621118,1.33464566929134,4.30708661417323,254,161
"420",35,21.5,12,349,753,0.0123999604782136,2.15759312320917,2.15759312320917,1.78717874239867,88,78,183,0.424523204565048,2.10240963855422,1.33716475095785,4.24521072796935,261,166
"421",36,1.52,1,120,123,0.0172268907563025,1.025,1.025,1.07664941419089,38,25,57,0.737590074539185,1.9047619047619,1.46341463414634,7.03658536585366,82,63
"422",36,3.74,2,207,278,0.013038788049341,1.34299516908213,1.34299516908213,1.35943614009503,61,46,100,0.607939481735229,1.93457943925234,1.41780821917808,5.79452054794521,146,107
"423",36,6.63,3,252,395,0.0124897236451021,1.56746031746032,1.56746031746032,1.50340191357088,71,55,126,0.556708872318268,2,1.39226519337017,5.23204419889503,181,126
"424",36,7.41,4,267,437,0.0123060460139112,1.63670411985019,1.63670411985019,1.51697767634563,72,56,139,0.55345892906189,2.0859375,1.36923076923077,5.09230769230769,195,128
"425",36,10.99,5,296,535,0.0122537792029317,1.80743243243243,1.80743243243243,1.63049130862491,80,67,149,0.506991028785706,2.01360544217687,1.37037037037037,4.76388888888889,216,147
"426",36,14.47,6,308,571,0.0120774990481831,1.8538961038961,1.8538961038961,1.64822211348429,81,70,157,0.499256193637848,2.03973509933775,1.3568281938326,4.63436123348018,227,151
"427",36,14.6,7,312,597,0.0123052188968588,1.91346153846154,1.91346153846154,1.65335514894142,81,70,161,0.443517118692398,2.06622516556291,1.35064935064935,4.58441558441558,231,151
"428",36,15.85,8,327,640,0.0120072794131442,1.95718654434251,1.95718654434251,1.69208171998714,84,72,171,0.437047123908997,2.09615384615385,1.34567901234568,4.44855967078189,243,156
"429",36,19.09,9,337,681,0.0120284018651971,2.02077151335312,2.02077151335312,1.72586866475862,86,75,176,0.409245282411575,2.09316770186335,1.34262948207171,4.34661354581673,251,161
"430",36,20.23,10,340,700,0.0121464515009544,2.05882352941176,2.05882352941176,1.73486315470499,86,75,179,0.425655126571655,2.11180124223603,1.33858267716535,4.31102362204724,254,161
"431",36,20.8,11,343,727,0.0123949329105076,2.11953352769679,2.11953352769679,1.78112268408736,87,77,179,0.410857290029526,2.09146341463415,1.33984375,4.28515625,256,164
"432",36,21.5,12,349,753,0.0123999604782136,2.15759312320917,2.15759312320917,1.78717874239867,88,78,183,0.424523204565048,2.10240963855422,1.33716475095785,4.24521072796935,261,166
"433",37,2.89,1,163,202,0.015299553131864,1.23926380368098,1.23926380368098,1.32935663673885,48,35,80,0.611067533493042,1.96385542168675,1.41739130434783,6.6,115,83
"434",37,3.67,2,201,283,0.0140796019900498,1.40796019900498,1.40796019900498,1.36853741443069,57,43,101,0.595375120639801,2.01,1.39583333333333,5.84722222222222,144,100
"435",37,3.8,3,217,324,0.0138248847926267,1.49308755760369,1.49308755760369,1.3839160263022,60,46,111,0.555555582046509,2.04716981132075,1.38216560509554,5.61783439490446,157,106
"436",37,4.94,4,230,368,0.0139737991266376,1.6,1.6,1.41826051277474,61,46,123,0.579863965511322,2.14953271028037,1.36094674556213,5.34319526627219,169,107
"437",37,5.51,5,243,415,0.014114206033398,1.70781893004115,1.70781893004115,1.59881962328453,65,49,129,0.53301203250885,2.13157894736842,1.36516853932584,5.1685393258427,178,114
"438",37,7.73,6,266,487,0.0138175627748617,1.83082706766917,1.83082706766917,1.64559226709925,69,54,143,0.5072922706604,2.16260162601626,1.3502538071066,5.01522842639594,197,123
"439",37,10.97,7,283,533,0.0133573916748114,1.88339222614841,1.88339222614841,1.70595318507884,73,59,151,0.494561582803726,2.14393939393939,1.34761904761905,4.80952380952381,210,132
"440",37,14.55,8,313,620,0.0126976325059392,1.98083067092652,1.98083067092652,1.73659854324103,81,68,164,0.477297127246857,2.1006711409396,1.34913793103448,4.54310344827586,232,149
"441",37,18.03,9,323,654,0.0125761975270657,2.02476780185758,2.02476780185758,1.74805107969038,82,72,169,0.473287224769592,2.0974025974026,1.3402489626556,4.44398340248963,241,154
"442",37,19.28,10,335,694,0.0124050406649388,2.07164179104478,2.07164179104478,1.76279126217652,85,74,176,0.429715603590012,2.10691823899371,1.34,4.348,250,159
"443",37,19.98,11,341,722,0.0124547179575643,2.11730205278592,2.11730205278592,1.7696502766845,86,75,180,0.456926554441452,2.11801242236025,1.33725490196078,4.30588235294118,255,161
"444",37,21.5,12,349,753,0.0123999604782136,2.15759312320917,2.15759312320917,1.78717874239867,88,78,183,0.424523204565048,2.10240963855422,1.33716475095785,4.24521072796935,261,166
"445",38,0.57,1,142,160,0.0159824193387274,1.12676056338028,1.12676056338028,1.50917260456006,45,31,66,0.703574180603027,1.86842105263158,1.4639175257732,6.31958762886598,97,76
"446",38,3.46,2,206,299,0.014160549372484,1.45145631067961,1.45145631067961,1.62684052929615,62,46,98,0.565497040748596,1.90740740740741,1.43055555555556,5.72222222222222,144,108
"447",38,6.94,3,229,352,0.013483490385352,1.53711790393013,1.53711790393013,1.62066615633208,64,50,115,0.549824893474579,2.00877192982456,1.38787878787879,5.4,165,114
"448",38,7.07,4,240,390,0.0135983263598326,1.625,1.625,1.65673470250278,65,51,124,0.545029580593109,2.06896551724138,1.37142857142857,5.22857142857143,175,116
"449",38,8.59,5,259,432,0.0129298733949897,1.66795366795367,1.66795366795367,1.68562924812473,70,56,133,0.5135298371315,2.05555555555556,1.37037037037037,5.07407407407407,189,126
"450",38,9.73,6,264,463,0.0133367899527595,1.75378787878788,1.75378787878788,1.68949407025957,70,57,137,0.517612159252167,2.07874015748031,1.36082474226804,4.97422680412371,194,127
"451",38,10.51,7,275,495,0.0131386861313869,1.8,1.8,1.64900072416696,71,58,146,0.514306724071503,2.13178294573643,1.34803921568627,4.88235294117647,204,129
"452",38,11.76,8,295,542,0.0124985587455321,1.83728813559322,1.83728813559322,1.68573085221921,76,62,157,0.4984170794487,2.13768115942029,1.34703196347032,4.69406392694064,219,138
"453",38,15,9,311,585,0.012135670573592,1.88102893890675,1.88102893890675,1.73573331216245,81,67,163,0.457977890968323,2.10135135135135,1.35217391304348,4.54347826086957,230,148
"454",38,15.7,10,318,615,0.0122016546634129,1.93396226415094,1.93396226415094,1.72929088101817,82,68,168,0.434868156909943,2.12,1.34745762711864,4.49576271186441,236,150
"455",38,19.28,11,338,695,0.0122030446157358,2.05621301775148,2.05621301775148,1.754077781403,87,76,175,0.441011279821396,2.07361963190184,1.34661354581673,4.31075697211155,251,163
"456",38,21.5,12,349,753,0.0123999604782136,2.15759312320917,2.15759312320917,1.78717874239867,88,78,183,0.424523204565048,2.10240963855422,1.33716475095785,4.24521072796935,261,166
"457",39,1.52,1,120,123,0.0172268907563025,1.025,1.025,1.07664941419089,38,25,57,0.737590074539185,1.9047619047619,1.46341463414634,7.03658536585366,82,63
"458",39,5,2,182,223,0.0135389472406047,1.22527472527473,1.22527472527473,1.32874286810372,56,40,86,0.630929589271545,1.89583333333333,1.44444444444444,6.1031746031746,126,96
"459",39,7.22,3,232,338,0.0126138229586505,1.45689655172414,1.45689655172414,1.42781413332648,66,51,115,0.540247142314911,1.98290598290598,1.39759036144578,5.46987951807229,166,117
"460",39,10.46,4,253,394,0.0123596210552732,1.55731225296443,1.55731225296443,1.56372440847277,71,57,125,0.551595628261566,1.9765625,1.39010989010989,5.16483516483517,182,128
"461",39,13.35,5,284,486,0.012093763997412,1.7112676056338,1.7112676056338,1.60929806184413,76,64,144,0.490639120340347,2.02857142857143,1.36538461538462,4.79807692307692,208,140
"462",39,13.48,6,291,520,0.0123237350396966,1.78694158075601,1.78694158075601,1.65578547390807,76,64,151,0.471902757883072,2.07857142857143,1.35348837209302,4.72558139534884,215,140
"463",39,14.73,7,307,568,0.012092567754572,1.85016286644951,1.85016286644951,1.69266144482275,80,68,159,0.482769429683685,2.07432432432432,1.35242290748899,4.63436123348018,227,148
"464",39,15.51,8,317,598,0.0119394641217107,1.88643533123028,1.88643533123028,1.66672484706742,81,68,168,0.458883374929428,2.12751677852349,1.34322033898305,4.53389830508475,236,149
"465",39,16.08,9,320,630,0.0123432601880878,1.96875,1.96875,1.74979216622747,82,70,168,0.459881544113159,2.10526315789474,1.34453781512605,4.50420168067227,238,152
"466",39,16.78,10,326,656,0.0123831996224634,2.01226993865031,2.01226993865031,1.75210498291026,83,71,172,0.451182335615158,2.11688311688312,1.34156378600823,4.45679012345679,243,154
"467",39,20.36,11,346,735,0.0123146519225936,2.1242774566474,2.1242774566474,1.78126103555556,88,78,180,0.429825574159622,2.08433734939759,1.34108527131783,4.27906976744186,258,166
"468",39,21.5,12,349,753,0.0123999604782136,2.15759312320917,2.15759312320917,1.78717874239867,88,78,183,0.424523204565048,2.10240963855422,1.33716475095785,4.24521072796935,261,166
"469",40,1.52,1,120,123,0.0172268907563025,1.025,1.025,1.07664941419089,38,25,57,0.737590074539185,1.9047619047619,1.46341463414634,7.03658536585366,82,63
"470",40,4.41,2,211,284,0.0128187767998195,1.34597156398104,1.34597156398104,1.36778047020215,63,45,103,0.598021268844604,1.9537037037037,1.42567567567568,5.79054054054054,148,108
"471",40,4.54,3,229,330,0.0126407722362675,1.4410480349345,1.4410480349345,1.45942639773436,66,48,115,0.558948636054993,2.00877192982456,1.40490797546012,5.52760736196319,163,114
"472",40,5.24,4,249,382,0.0123720689208447,1.53413654618474,1.53413654618474,1.49465944777384,69,49,131,0.553449034690857,2.11016949152542,1.38333333333333,5.25555555555556,180,118
"473",40,8.82,5,278,479,0.0124405890450095,1.72302158273381,1.72302158273381,1.58795978256526,77,61,140,0.496859759092331,2.01449275362319,1.38308457711443,4.92537313432836,201,138
"474",40,9.6,6,292,518,0.0121922515652215,1.77397260273973,1.77397260273973,1.5782546015309,78,65,149,0.484323024749756,2.04195804195804,1.36448598130841,4.75700934579439,214,143
"475",40,11.82,7,310,595,0.0124230086647876,1.91935483870968,1.91935483870968,1.6568736013611,81,68,161,0.474421322345734,2.08053691275168,1.35371179039301,4.61572052401747,229,149
"476",40,15.3,8,320,629,0.0123236677115987,1.965625,1.965625,1.67515706502251,82,71,167,0.450881004333496,2.09150326797386,1.34453781512605,4.50420168067227,238,153
"477",40,15.87,9,324,659,0.0125941214692505,2.03395061728395,2.03395061728395,1.72336969138598,83,73,168,0.445131123065948,2.07692307692308,1.34439834024896,4.46473029045643,241,156
"478",40,17.01,10,328,680,0.0126799433131946,2.07317073170732,2.07317073170732,1.7299688397458,83,73,172,0.430357962846756,2.1025641025641,1.33877551020408,4.41224489795918,245,156
"479",40,18.26,11,340,716,0.012424084678119,2.10588235294118,2.10588235294118,1.75191769590306,86,75,179,0.429503411054611,2.11180124223602,1.33858267716535,4.32677165354331,254,161
"480",40,21.5,12,349,753,0.0123999604782136,2.15759312320917,2.15759312320917,1.78717874239867,88,78,183,0.424523204565048,2.10240963855422,1.33716475095785,4.24521072796935,261,166
"481",41,0.78,1,137,147,0.0157793044224989,1.07299270072993,1.07299270072993,1.13376587282185,42,25,70,0.767758846282959,2.04477611940298,1.44210526315789,6.95789473684211,95,67
"482",41,4.02,2,197,246,0.0127421526986429,1.24873096446701,1.24873096446701,1.40906240940849,56,42,99,0.671805799007416,2.01020408163265,1.39716312056738,5.64539007092199,141,98
"483",41,4.59,3,220,307,0.0127438771274388,1.39545454545455,1.39545454545455,1.6368485346205,64,46,110,0.590674698352814,2,1.41025641025641,5.50641025641026,156,110
"484",41,6.11,4,238,352,0.0124809417437861,1.47899159663866,1.47899159663866,1.65000173695226,68,54,116,0.557011902332306,1.95081967213115,1.4,5.31176470588235,170,122
"485",41,7.36,5,263,422,0.0122485705163556,1.60456273764259,1.60456273764259,1.71796612673272,75,58,130,0.548339486122131,1.97744360902256,1.39893617021277,5.06914893617021,188,133
"486",41,7.49,6,269,455,0.0126227598069134,1.69144981412639,1.69144981412639,1.69519321849014,75,58,136,0.524183034896851,2.02255639097744,1.38659793814433,4.96907216494845,194,133
"487",41,10.97,7,284,494,0.0122928383018962,1.73943661971831,1.73943661971831,1.73135959340445,78,61,145,0.490298569202423,2.0431654676259,1.37864077669903,4.81067961165049,206,139
"488",41,13.86,8,307,562,0.0119648293627983,1.83061889250814,1.83061889250814,1.71360445984584,81,67,159,0.472065329551697,2.07432432432432,1.35840707964602,4.60176991150442,226,148
"489",41,16.08,9,320,630,0.0123432601880878,1.96875,1.96875,1.74979216622747,82,70,168,0.459881544113159,2.10526315789474,1.34453781512605,4.50420168067227,238,152
"490",41,16.78,10,326,656,0.0123831996224634,2.01226993865031,2.01226993865031,1.75210498291026,83,71,172,0.451182335615158,2.11688311688312,1.34156378600823,4.45679012345679,243,154
"491",41,20.36,11,346,735,0.0123146519225936,2.1242774566474,2.1242774566474,1.78126103555556,88,78,180,0.429825574159622,2.08433734939759,1.34108527131783,4.27906976744186,258,166
"492",41,21.5,12,349,753,0.0123999604782136,2.15759312320917,2.15759312320917,1.78717874239867,88,78,183,0.424523204565048,2.10240963855422,1.33716475095785,4.24521072796935,261,166
"493",42,0.13,1,110,118,0.0196830692243536,1.07272727272727,1.07272727272727,1.0390487353936,31,22,57,0.75061047077179,2.07547169811321,1.39240506329114,6.9873417721519,79,53
"494",42,1.65,2,167,202,0.0145732631123296,1.20958083832335,1.20958083832335,1.22029294652676,49,32,86,0.63547694683075,2.06172839506173,1.41525423728814,6.07627118644068,118,81
"495",42,2.43,3,200,267,0.0134170854271357,1.335,1.335,1.27279365104555,55,41,104,0.602526366710663,2.08333333333333,1.37931034482759,5.73793103448276,145,96
"496",42,3.68,4,234,348,0.0127654891603389,1.48717948717949,1.48717948717949,1.43045442221926,67,48,119,0.551344335079193,2.03478260869565,1.40119760479042,5.33532934131737,167,115
"497",42,4.25,5,247,398,0.0131002929462493,1.61133603238866,1.61133603238866,1.61246532898017,69,53,125,0.519721746444702,2.02459016393443,1.3876404494382,5.23033707865169,178,122
"498",42,7.14,6,277,479,0.0125307382409878,1.72924187725632,1.72924187725632,1.65064930054561,74,59,144,0.503833293914795,2.08270676691729,1.36453201970443,4.92610837438424,203,133
"499",42,7.84,7,285,513,0.0126760563380282,1.8,1.8,1.63493528586786,75,60,150,0.459974378347397,2.11111111111111,1.35714285714286,4.84285714285714,210,135
"500",42,11.32,8,298,548,0.0123833412424016,1.83892617449664,1.83892617449664,1.65900459884318,77,63,158,0.443835258483887,2.12857142857143,1.34841628959276,4.70135746606335,221,140
"501",42,13.54,9,314,616,0.0125353574408335,1.96178343949045,1.96178343949045,1.71124750101612,81,67,166,0.410985738039017,2.12162162162162,1.34763948497854,4.59227467811159,233,148
"502",42,17.12,10,336,696,0.0123667377398721,2.07142857142857,2.07142857142857,1.74725013331742,86,75,175,0.436958074569702,2.08695652173913,1.344,4.376,250,161
"503",42,20.36,11,346,735,0.0123146519225936,2.1242774566474,2.1242774566474,1.78126103555556,88,78,180,0.429825574159622,2.08433734939759,1.34108527131783,4.27906976744186,258,166
"504",42,21.5,12,349,753,0.0123999604782136,2.15759312320917,2.15759312320917,1.78717874239867,88,78,183,0.424523204565048,2.10240963855422,1.33716475095785,4.24521072796935,261,166
"505",43,1.52,1,120,123,0.0172268907563025,1.025,1.025,1.07664941419089,38,25,57,0.737590074539185,1.9047619047619,1.46341463414634,7.03658536585366,82,63
"506",43,1.65,2,167,202,0.0145732631123296,1.20958083832335,1.20958083832335,1.22029294652676,49,32,86,0.63547694683075,2.06172839506173,1.41525423728814,6.07627118644068,118,81
"507",43,5.13,3,199,271,0.0137556469214761,1.36180904522613,1.36180904522613,1.38852085285072,57,41,101,0.573569297790527,2.03061224489796,1.40140845070423,5.8943661971831,142,98
"508",43,8.02,4,245,378,0.0126463700234192,1.54285714285714,1.54285714285714,1.50798805517287,69,51,125,0.527599334716797,2.04166666666667,1.39204545454545,5.30681818181818,176,120
"509",43,8.72,5,263,425,0.0123356456622065,1.61596958174905,1.61596958174905,1.53220802026501,71,52,140,0.501331448554993,2.13821138211382,1.36979166666667,5.06770833333333,192,123
"510",43,12.3,6,289,518,0.0124471357170319,1.7923875432526,1.7923875432526,1.62377593374346,78,64,147,0.479703634977341,2.03521126760563,1.3696682464455,4.7914691943128,211,142
"511",43,15.54,7,308,567,0.011992893100385,1.84090909090909,1.84090909090909,1.66238971403533,82,69,157,0.485397636890411,2.03973509933775,1.36283185840708,4.58849557522124,226,151
"512",43,16.79,8,320,612,0.0119905956112853,1.9125,1.9125,1.69735624395282,85,72,163,0.454846441745758,2.03821656050955,1.36170212765957,4.48510638297872,235,157
"513",43,17.93,9,323,635,0.0122108339903467,1.96594427244582,1.96594427244582,1.71926824986575,85,73,165,0.453986048698425,2.04430379746835,1.35714285714286,4.4453781512605,238,158
"514",43,18.71,10,335,665,0.0118866744123693,1.98507462686567,1.98507462686567,1.70564395452669,86,74,175,0.445198744535446,2.09375,1.34538152610442,4.33734939759036,249,160
"515",43,19.28,11,338,695,0.0122030446157358,2.05621301775148,2.05621301775148,1.754077781403,87,76,175,0.441011279821396,2.07361963190184,1.34661354581673,4.31075697211155,251,163
"516",43,21.5,12,349,753,0.0123999604782136,2.15759312320917,2.15759312320917,1.78717874239867,88,78,183,0.424523204565048,2.10240963855422,1.33716475095785,4.24521072796935,261,166
"517",44,0.78,1,137,147,0.0157793044224989,1.07299270072993,1.07299270072993,1.13376587282185,42,25,70,0.767758846282959,2.04477611940298,1.44210526315789,6.95789473684211,95,67
"518",44,4.26,2,185,233,0.013689776733255,1.25945945945946,1.25945945945946,1.28713994722152,55,37,93,0.683195471763611,2.01086956521739,1.42307692307692,6.02307692307692,130,92
"519",44,7.15,3,230,340,0.0129105752800456,1.47826086956522,1.47826086956522,1.41035388449468,65,49,116,0.590211987495422,2.01754385964912,1.39393939393939,5.44242424242424,165,114
"520",44,7.85,4,252,388,0.0122683867703788,1.53968253968254,1.53968253968254,1.43459609690623,68,51,133,0.568787276744843,2.11764705882353,1.3695652173913,5.16847826086957,184,119
"521",44,9.37,5,275,430,0.011413404114134,1.56363636363636,1.56363636363636,1.47608475205877,72,56,147,0.515470504760742,2.1484375,1.35467980295566,4.96551724137931,203,128
"522",44,11.59,6,294,511,0.0118641313180562,1.73809523809524,1.73809523809524,1.56171642411964,76,61,157,0.507609486579895,2.14598540145985,1.34862385321101,4.78440366972477,218,137
"523",44,12.73,7,298,538,0.0121573678620658,1.80536912751678,1.80536912751678,1.57545705404145,76,61,161,0.486145824193954,2.17518248175183,1.34234234234234,4.72072072072072,222,137
"524",44,13.98,8,312,582,0.0119960425426663,1.86538461538462,1.86538461538462,1.62406996541007,80,65,167,0.470729857683182,2.15172413793103,1.3448275862069,4.60344827586207,232,145
"525",44,17.56,9,334,668,0.012012012012012,2,2,1.7168131661446,85,73,176,0.466372311115265,2.11392405063291,1.34136546184739,4.3855421686747,249,158
"526",44,20.8,10,343,705,0.0120198455321978,2.05539358600583,2.05539358600583,1.75496877888098,87,76,180,0.461600542068481,2.10429447852761,1.33984375,4.30078125,256,163
"527",44,20.93,11,346,727,0.0121806148948647,2.10115606936416,2.10115606936416,1.75428805533464,87,76,183,0.430474996566772,2.12269938650307,1.33590733590734,4.27027027027027,259,163
"528",44,21.5,12,349,753,0.0123999604782136,2.15759312320917,2.15759312320917,1.78717874239867,88,78,183,0.424523204565048,2.10240963855422,1.33716475095785,4.24521072796935,261,166
"529",45,0.78,1,137,147,0.0157793044224989,1.07299270072993,1.07299270072993,1.13376587282185,42,25,70,0.767758846282959,2.04477611940298,1.44210526315789,6.95789473684211,95,67
"530",45,2.3,2,181,217,0.0133210558624923,1.19889502762431,1.19889502762431,1.25706912826819,53,39,89,0.665569543838501,1.96739130434783,1.4140625,6.125,128,92
"531",45,5.88,3,235,347,0.0126204764502637,1.47659574468085,1.47659574468085,1.46608379251907,68,56,111,0.576954364776611,1.89516129032258,1.40718562874251,5.40119760479042,167,124
"532",45,9.12,4,261,409,0.0120542292956086,1.56704980842912,1.56704980842912,1.58603824866001,75,62,124,0.53120493888855,1.90510948905109,1.40322580645161,5.06451612903226,186,137
"533",45,11.34,5,285,499,0.0123301210773412,1.75087719298246,1.75087719298246,1.64059063691168,79,65,141,0.498086392879486,1.97916666666667,1.38349514563107,4.85922330097087,206,144
"534",45,11.91,6,294,536,0.0124445682709944,1.82312925170068,1.82312925170068,1.72289161734275,81,67,146,0.476002067327499,1.98648648648649,1.38028169014085,4.79342723004695,213,148
"535",45,15.39,7,306,574,0.0123004393014036,1.87581699346405,1.87581699346405,1.75069344495068,82,70,154,0.462576925754547,2.01315789473684,1.36607142857143,4.66071428571429,224,152
"536",45,16.09,8,318,610,0.0121024542189949,1.91823899371069,1.91823899371069,1.75235793349043,83,71,164,0.465150505304337,2.06493506493507,1.3531914893617,4.53191489361702,235,154
"537",45,17.23,9,321,633,0.0123247663551402,1.97196261682243,1.97196261682243,1.7831813386557,83,72,166,0.429764747619629,2.07096774193548,1.34873949579832,4.49159663865546,238,155
"538",45,20.12,10,336,693,0.0123134328358209,2.0625,2.0625,1.76942929643608,85,76,175,0.447752118110657,2.08695652173913,1.33864541832669,4.33864541832669,251,161
"539",45,20.25,11,339,717,0.0125150547206367,2.11504424778761,2.11504424778761,1.7706587744849,85,76,178,0.435257375240326,2.1055900621118,1.33464566929134,4.30708661417323,254,161
"540",45,21.5,12,349,753,0.0123999604782136,2.15759312320917,2.15759312320917,1.78717874239867,88,78,183,0.424523204565048,2.10240963855422,1.33716475095785,4.24521072796935,261,166
"541",46,0.13,1,110,118,0.0196830692243536,1.07272727272727,1.07272727272727,1.0390487353936,31,22,57,0.75061047077179,2.07547169811321,1.39240506329114,6.9873417721519,79,53
"542",46,3.61,2,165,210,0.0155210643015521,1.27272727272727,1.27272727272727,1.28803507151222,46,34,85,0.628605484962463,2.0625,1.38655462184874,6.52100840336134,119,80
"543",46,4.18,3,200,285,0.014321608040201,1.425,1.425,1.58163885525044,55,42,103,0.583120942115784,2.06185567010309,1.37931034482759,5.81379310344828,145,97
"544",46,7.07,4,240,390,0.0135983263598326,1.625,1.625,1.65673470250278,65,51,124,0.545029580593109,2.06896551724138,1.37142857142857,5.22857142857143,175,116
"545",46,10.31,5,265,444,0.0126929674099485,1.67547169811321,1.67547169811321,1.70408483756967,72,57,136,0.496081322431564,2.05426356589147,1.37305699481865,4.94818652849741,193,129
"546",46,13.89,6,298,534,0.0120669785099315,1.79194630872483,1.79194630872483,1.73206167401082,80,67,151,0.479237735271454,2.02721088435374,1.36697247706422,4.69266055045872,218,147
"547",46,14.59,7,307,572,0.0121777266824211,1.86319218241042,1.86319218241042,1.71770560505519,81,69,157,0.470782458782196,2.04666666666667,1.35840707964602,4.58849557522124,226,150
"548",46,15.73,8,310,597,0.0124647666771062,1.9258064516129,1.9258064516129,1.73640328035367,81,70,159,0.439228534698486,2.05298013245033,1.35371179039301,4.54585152838428,229,151
"549",46,17.25,9,319,628,0.0123814593560853,1.96865203761755,1.96865203761755,1.75540380692974,83,73,163,0.476063907146454,2.04487179487179,1.35169491525424,4.47033898305085,236,156
"550",46,18.03,10,327,657,0.0123262227725559,2.00917431192661,2.00917431192661,1.73621369174931,84,74,169,0.457758456468582,2.06962025316456,1.34567901234568,4.39094650205761,243,158
"551",46,19.28,11,338,695,0.0122030446157358,2.05621301775148,2.05621301775148,1.754077781403,87,76,175,0.441011279821396,2.07361963190184,1.34661354581673,4.31075697211155,251,163
"552",46,21.5,12,349,753,0.0123999604782136,2.15759312320917,2.15759312320917,1.78717874239867,88,78,183,0.424523204565048,2.10240963855422,1.33716475095785,4.24521072796935,261,166
"553",47,3.24,1,156,170,0.0140612076095947,1.08974358974359,1.08974358974359,1.2866994561933,48,32,76,0.721903145313263,1.95,1.44444444444444,6.05555555555556,108,80
"554",47,3.37,2,179,230,0.0144372606867114,1.28491620111732,1.28491620111732,1.35863489849515,51,37,91,0.641446113586426,2.03409090909091,1.3984375,5.8203125,128,88
"555",47,6.85,3,212,298,0.013323795046052,1.40566037735849,1.40566037735849,1.50404310349121,60,45,107,0.561624526977539,2.01904761904762,1.39473684210526,5.65131578947368,152,105
"556",47,7.55,4,235,353,0.0128386979450809,1.50212765957447,1.50212765957447,1.50803469530644,66,47,122,0.544531285762787,2.07964601769911,1.3905325443787,5.36686390532544,169,113
"557",47,8.8,5,254,416,0.0129469982260123,1.63779527559055,1.63779527559055,1.60338443709583,72,53,129,0.540744066238403,2.032,1.3956043956044,5.15934065934066,182,125
"558",47,9.94,6,259,446,0.0133488970698273,1.72200772200772,1.72200772200772,1.64330655542983,72,56,131,0.510051965713501,2.0234375,1.38502673796791,5.06951871657754,187,128
"559",47,10.72,7,277,483,0.0126353790613718,1.74368231046931,1.74368231046931,1.62018935164393,75,57,145,0.494035303592682,2.09848484848485,1.37128712871287,4.83168316831683,202,132
"560",47,14.3,8,305,576,0.0124245038826575,1.88852459016393,1.88852459016393,1.68769500511243,81,66,158,0.478297054767609,2.07482993197279,1.36160714285714,4.57589285714286,224,147
"561",47,17.19,9,325,634,0.0120417853751187,1.95076923076923,1.95076923076923,1.68271175249905,84,71,170,0.458240389823914,2.09677419354839,1.34854771784232,4.41078838174274,241,155
"562",47,19.41,10,337,696,0.0122933446375583,2.06528189910979,2.06528189910979,1.73467767414048,85,73,179,0.432312309741974,2.13291139240506,1.33730158730159,4.33730158730159,252,158
"563",47,19.98,11,341,722,0.0124547179575643,2.11730205278592,2.11730205278592,1.7696502766845,86,75,180,0.456926554441452,2.11801242236025,1.33725490196078,4.30588235294118,255,161
"564",47,21.5,12,349,753,0.0123999604782136,2.15759312320917,2.15759312320917,1.78717874239867,88,78,183,0.424523204565048,2.10240963855422,1.33716475095785,4.24521072796935,261,166
"565",48,1.25,1,132,163,0.018852648623641,1.23484848484848,1.23484848484848,1.33070044194863,42,28,62,0.615510582923889,1.88571428571429,1.46666666666667,7.02222222222222,90,70
"566",48,2.03,2,187,247,0.0142027485480996,1.32085561497326,1.32085561497326,1.4117440011765,57,37,93,0.599427938461304,1.98936170212766,1.43846153846154,6.10769230769231,130,94
"567",48,2.73,3,215,307,0.0133449250163008,1.42790697674419,1.42790697674419,1.41743122563241,61,44,110,0.571618854999542,2.04761904761905,1.3961038961039,5.64935064935065,154,105
"568",48,6.31,4,258,421,0.0126986999668205,1.63178294573643,1.63178294573643,1.54714339045724,72,56,130,0.514768123626709,2.015625,1.38709677419355,5.09139784946237,186,128
"569",48,7.45,5,269,461,0.0127892137823892,1.71375464684015,1.71375464684015,1.5743744782888,73,58,138,0.514612674713135,2.05343511450382,1.37244897959184,4.91836734693878,196,131
"570",48,10.69,6,289,509,0.0122308727412534,1.76124567474048,1.76124567474048,1.68035730373531,78,63,148,0.495084464550018,2.04964539007092,1.3696682464455,4.74881516587678,211,141
"571",48,12.91,7,308,577,0.0122044079698803,1.87337662337662,1.87337662337662,1.73091853460424,81,65,162,0.4960877597332,2.10958904109589,1.3568281938326,4.6431718061674,227,146
"572",48,13.48,8,316,607,0.0121961020695198,1.92088607594937,1.92088607594937,1.77526375851065,84,67,165,0.440998643636703,2.09271523178808,1.36206896551724,4.58620689655172,232,151
"573",48,16.37,9,329,667,0.0123619245310994,2.0273556231003,2.0273556231003,1.76479127140349,85,72,172,0.476481795310974,2.09554140127389,1.34836065573771,4.4344262295082,244,157
"574",48,16.5,10,332,690,0.0125577840061151,2.07831325301205,2.07831325301205,1.75707128910711,85,72,175,0.437548786401749,2.11464968152866,1.34412955465587,4.40080971659919,247,157
"575",48,18.02,11,340,723,0.0125455491931286,2.12647058823529,2.12647058823529,1.76872581738239,87,75,178,0.414171606302261,2.09876543209877,1.34387351778656,4.33596837944664,253,162
"576",48,21.5,12,349,753,0.0123999604782136,2.15759312320917,2.15759312320917,1.78717874239867,88,78,183,0.424523204565048,2.10240963855422,1.33716475095785,4.24521072796935,261,166
"577",49,1.14,1,114,141,0.0218910107126223,1.23684210526316,1.23684210526316,1.17486110561291,37,25,52,0.668024718761444,1.83870967741935,1.48051948051948,7.28571428571429,77,62
"578",49,2.39,2,167,237,0.0170983334535748,1.41916167664671,1.41916167664671,1.40573239953255,51,38,78,0.59302282333374,1.87640449438202,1.43965517241379,6.43103448275862,116,89
"579",49,5.28,3,218,339,0.0143322200143745,1.55504587155963,1.55504587155963,1.45299908735104,61,45,112,0.524255812168121,2.05660377358491,1.38853503184713,5.6687898089172,157,106
"580",49,8.76,4,241,392,0.0135546334716459,1.62655601659751,1.62655601659751,1.50927391520249,67,51,123,0.525350749492645,2.04237288135593,1.38505747126437,5.2816091954023,174,118
"581",49,10.98,5,277,481,0.0125830586511798,1.73646209386282,1.73646209386282,1.56786143193828,74,60,143,0.537592768669128,2.06716417910448,1.36453201970443,4.93103448275862,203,134
"582",49,11.68,6,286,514,0.0126119494540547,1.7972027972028,1.7972027972028,1.61071708254187,75,61,150,0.512965738773346,2.10294117647059,1.35545023696682,4.84834123222749,211,136
"583",49,12.25,7,292,547,0.0128748293555524,1.87328767123288,1.87328767123288,1.69743583266996,76,63,153,0.483120441436768,2.10071942446043,1.35185185185185,4.79166666666667,216,139
"584",49,12.38,8,296,573,0.0131241410902428,1.93581081081081,1.93581081081081,1.70821873559522,76,63,157,0.460227429866791,2.1294964028777,1.34545454545455,4.73636363636364,220,139
"585",49,15.96,9,323,656,0.0126146568467204,2.03095975232198,2.03095975232198,1.74226549045091,82,72,169,0.456095933914185,2.0974025974026,1.3402489626556,4.46058091286307,241,154
"586",49,19.2,10,334,696,0.0125155095214975,2.08383233532934,2.08383233532934,1.78429388326466,85,75,174,0.463866800069809,2.0875,1.34136546184739,4.37349397590361,249,160
"587",49,19.98,11,341,722,0.0124547179575643,2.11730205278592,2.11730205278592,1.7696502766845,86,75,180,0.456926554441452,2.11801242236025,1.33725490196078,4.30588235294118,255,161
"588",49,21.5,12,349,753,0.0123999604782136,2.15759312320917,2.15759312320917,1.78717874239867,88,78,183,0.424523204565048,2.10240963855422,1.33716475095785,4.24521072796935,261,166
"589",50,3.24,1,156,170,0.0140612076095947,1.08974358974359,1.08974358974359,1.2866994561933,48,32,76,0.721903145313263,1.95,1.44444444444444,6.05555555555556,108,80
"590",50,6.13,2,223,301,0.0121601422049853,1.34977578475336,1.34977578475336,1.45028902581616,65,46,112,0.561053395271301,2.00900900900901,1.41139240506329,5.5,158,111
"591",50,8.35,3,249,400,0.0129550459904133,1.60642570281124,1.60642570281124,1.56497553894622,69,56,124,0.547043800354004,1.992,1.38333333333333,5.21111111111111,180,125
"592",50,9.13,4,264,440,0.0126742712294043,1.66666666666667,1.66666666666667,1.55858959348269,70,57,137,0.532853782176971,2.07874015748031,1.36082474226804,5.05154639175258,194,127
"593",50,9.7,5,274,481,0.0128606187000348,1.75547445255474,1.75547445255474,1.70183628486453,73,59,142,0.495640993118286,2.07575757575758,1.36318407960199,4.94029850746269,201,132
"594",50,13.18,6,290,524,0.0125044744063954,1.80689655172414,1.80689655172414,1.69698299426762,75,63,152,0.514689922332764,2.10144927536232,1.34883720930233,4.77209302325581,215,138
"595",50,16.76,7,316,611,0.0122764717701427,1.93354430379747,1.93354430379747,1.74100749785218,82,72,162,0.474503129720688,2.05194805194805,1.35042735042735,4.52991452991453,234,154
"596",50,17.9,8,319,630,0.0124208907553085,1.97492163009404,1.97492163009404,1.74893534152145,82,72,165,0.458992153406143,2.07142857142857,1.34599156118143,4.48945147679325,237,154
"597",50,19.15,9,331,672,0.0123043120021972,2.03021148036254,2.03021148036254,1.76508956159033,85,74,172,0.443777918815613,2.08176100628931,1.34552845528455,4.39024390243902,246,159
"598",50,20.67,10,339,705,0.0123055977378646,2.07964601769911,2.07964601769911,1.78176726667352,87,77,175,0.462940514087677,2.06707317073171,1.3452380952381,4.32539682539683,252,164
"599",50,21.37,11,346,731,0.0122476334087292,2.11271676300578,2.11271676300578,1.78827717377754,88,78,180,0.458441913127899,2.08433734939759,1.34108527131783,4.27519379844961,258,166
"600",50,21.5,12,349,753,0.0123999604782136,2.15759312320917,2.15759312320917,1.78717874239867,88,78,183,0.424523204565048,2.10240963855422,1.33716475095785,4.24521072796935,261,166
"601",51,0.78,1,137,147,0.0157793044224989,1.07299270072993,1.07299270072993,1.13376587282185,42,25,70,0.767758846282959,2.04477611940298,1.44210526315789,6.95789473684211,95,67
"602",51,1.35,2,185,236,0.0138660399529965,1.27567567567568,1.27567567567568,1.50135561108008,55,38,92,0.618060648441315,1.98924731182796,1.42307692307692,6.03846153846154,130,93
"603",51,4.93,3,238,361,0.0128000567315534,1.51680672268908,1.51680672268908,1.60203353316498,69,54,115,0.532753765583038,1.9349593495935,1.40828402366864,5.37869822485207,169,123
"604",51,7.82,4,268,454,0.0126893621778747,1.69402985074627,1.69402985074627,1.63365541785864,75,61,132,0.537297010421753,1.97058823529412,1.38860103626943,4.98963730569948,193,136
"605",51,11.06,5,288,502,0.0121467286101432,1.74305555555556,1.74305555555556,1.69357120987436,80,65,143,0.501597225666046,1.98620689655172,1.38461538461538,4.77884615384615,208,145
"606",51,12.2,6,293,529,0.0123661695263921,1.80546075085324,1.80546075085324,1.71204713669228,80,65,148,0.491832882165909,2.02068965517241,1.37558685446009,4.70892018779343,213,145
"607",51,12.9,7,304,564,0.0122459614382491,1.85526315789474,1.85526315789474,1.71336396911366,81,68,155,0.468944877386093,2.04026845637584,1.36322869955157,4.60089686098655,223,149
"608",51,15.12,8,319,627,0.0123617436564736,1.96551724137931,1.96551724137931,1.75146231066265,82,70,167,0.480559796094894,2.09868421052632,1.34599156118143,4.50632911392405,237,152
"609",51,15.25,9,322,652,0.0126158549563669,2.02484472049689,2.02484472049689,1.74505390743486,82,70,170,0.432991653680801,2.11842105263158,1.34166666666667,4.47083333333333,240,152
"610",51,18.73,10,331,686,0.0125606518355763,2.07250755287009,2.07250755287009,1.75469729652157,83,73,175,0.432174324989319,2.12179487179487,1.33467741935484,4.37096774193548,248,156
"611",51,19.98,11,341,722,0.0124547179575643,2.11730205278592,2.11730205278592,1.7696502766845,86,75,180,0.456926554441452,2.11801242236025,1.33725490196078,4.30588235294118,255,161
"612",51,21.5,12,349,753,0.0123999604782136,2.15759312320917,2.15759312320917,1.78717874239867,88,78,183,0.424523204565048,2.10240963855422,1.33716475095785,4.24521072796935,261,166
"613",52,1.52,1,120,123,0.0172268907563025,1.025,1.025,1.07664941419089,38,25,57,0.737590074539185,1.9047619047619,1.46341463414634,7.03658536585366,82,63
"614",52,3.74,2,207,278,0.013038788049341,1.34299516908213,1.34299516908213,1.35943614009503,61,46,100,0.607939481735229,1.93457943925234,1.41780821917808,5.79452054794521,146,107
"615",52,3.87,3,222,326,0.0132893074069545,1.46846846846847,1.46846846846847,1.40539526758753,62,47,113,0.596042335033417,2.03669724770642,1.3875,5.50625,160,109
"616",52,7.11,4,245,390,0.0130478420876547,1.59183673469388,1.59183673469388,1.55508394355472,67,53,125,0.548261046409607,2.04166666666667,1.37640449438202,5.17977528089888,178,120
"617",52,10,5,278,482,0.0125185050515544,1.73381294964029,1.73381294964029,1.63952192918006,74,61,143,0.498984217643738,2.05925925925926,1.36274509803922,4.87254901960784,204,135
"618",52,13.48,6,291,520,0.0123237350396966,1.78694158075601,1.78694158075601,1.65578547390807,76,64,151,0.471902757883072,2.07857142857143,1.35348837209302,4.72558139534884,215,140
"619",52,17.06,7,315,606,0.0122535638459205,1.92380952380952,1.92380952380952,1.71602648382231,82,72,161,0.435768812894821,2.04545454545455,1.3519313304721,4.53648068669528,233,154
"620",52,17.63,8,321,639,0.0124415887850467,1.99065420560748,1.99065420560748,1.78160168522342,83,74,164,0.457310557365417,2.04458598726115,1.34873949579832,4.48739495798319,238,157
"621",52,18.77,9,324,658,0.012575010511027,2.03086419753086,2.03086419753086,1.78522132231615,83,74,167,0.453767538070679,2.06369426751592,1.34439834024896,4.44813278008299,241,157
"622",52,19.55,10,331,687,0.0125789618236748,2.07552870090634,2.07552870090634,1.76351855952467,84,75,172,0.410711258649826,2.08176100628931,1.34008097165992,4.37651821862348,247,159
"623",52,20.8,11,343,727,0.0123949329105076,2.11953352769679,2.11953352769679,1.78112268408736,87,77,179,0.410857290029526,2.09146341463415,1.33984375,4.28515625,256,164
"624",52,21.5,12,349,753,0.0123999604782136,2.15759312320917,2.15759312320917,1.78717874239867,88,78,183,0.424523204565048,2.10240963855422,1.33716475095785,4.24521072796935,261,166
"625",53,3.58,1,171,218,0.0149982800137599,1.27485380116959,1.27485380116959,1.32365427157769,51,39,81,0.601738095283508,1.9,1.425,6.25833333333333,120,90
"626",53,4.36,2,213,299,0.0132429798919302,1.4037558685446,1.4037558685446,1.39527472945241,62,49,102,0.601150989532471,1.91891891891892,1.41059602649007,5.70198675496689,151,111
"627",53,4.49,3,230,343,0.0130244921207519,1.49130434782609,1.49130434782609,1.38680161717757,65,50,115,0.539307594299316,2,1.39393939393939,5.42424242424242,165,115
"628",53,5.74,4,253,412,0.012924273793839,1.62845849802372,1.62845849802372,1.51264648547035,71,53,129,0.513926804065704,2.04032258064516,1.39010989010989,5.15384615384615,182,124
"629",53,8.63,5,279,488,0.0125834816018153,1.74910394265233,1.74910394265233,1.55344875056298,75,61,143,0.504646360874176,2.05147058823529,1.36764705882353,4.85294117647059,204,136
"630",53,11.87,6,299,542,0.0121658324167808,1.81270903010033,1.81270903010033,1.60724512257134,80,65,154,0.486628711223602,2.06206896551724,1.36529680365297,4.65753424657534,219,145
"631",53,12.57,7,307,576,0.0122628856102702,1.87622149837134,1.87622149837134,1.632085426463,82,68,157,0.463832587003708,2.04666666666667,1.36444444444444,4.58666666666667,225,150
"632",53,13.14,8,315,610,0.0123344454554646,1.93650793650794,1.93650793650794,1.6969244581503,84,70,161,0.466464638710022,2.04545454545455,1.36363636363636,4.51515151515152,231,154
"633",53,16.62,9,326,643,0.0121378008494573,1.97239263803681,1.97239263803681,1.71453640628268,85,73,168,0.43463522195816,2.06329113924051,1.35269709543568,4.4149377593361,241,158
"634",53,17.76,10,329,664,0.0123063236711394,2.01823708206687,2.01823708206687,1.73286781841693,85,73,171,0.442265242338181,2.08227848101266,1.3483606557377,4.37704918032787,244,158
"635",53,19.28,11,338,695,0.0122030446157358,2.05621301775148,2.05621301775148,1.754077781403,87,76,175,0.441011279821396,2.07361963190184,1.34661354581673,4.31075697211155,251,163
"636",53,21.5,12,349,753,0.0123999604782136,2.15759312320917,2.15759312320917,1.78717874239867,88,78,183,0.424523204565048,2.10240963855422,1.33716475095785,4.24521072796935,261,166
"637",54,3.48,1,144,158,0.0153457653457653,1.09722222222222,1.09722222222222,1.24917081106252,45,30,69,0.688811957836151,1.92,1.45454545454545,6.97979797979798,99,75
"638",54,4.05,2,185,240,0.0141010575793184,1.2972972972973,1.2972972972973,1.56314298364508,54,39,92,0.61678820848465,1.98924731182796,1.41221374045802,6.03053435114504,131,93
"639",54,4.75,3,212,300,0.0134132164893141,1.41509433962264,1.41509433962264,1.52874731455662,59,43,110,0.549349963665009,2.07843137254902,1.38562091503268,5.69281045751634,153,102
"640",54,7.64,4,246,396,0.0131408661025386,1.60975609756098,1.60975609756098,1.58380455655739,66,52,128,0.500580310821533,2.08474576271186,1.36666666666667,5.17777777777778,180,118
"641",54,8.78,5,250,429,0.0137831325301205,1.716,1.716,1.59820659101733,66,53,131,0.484631180763245,2.10084033613445,1.35869565217391,5.09239130434783,184,119
"642",54,11,6,277,502,0.013132422958196,1.81227436823105,1.81227436823105,1.64677209212139,72,58,147,0.478772163391113,2.13076923076923,1.35121951219512,4.8780487804878,205,130
"643",54,11.13,7,281,531,0.0134977122521607,1.88967971530249,1.88967971530249,1.67928728362402,72,58,151,0.452392339706421,2.16153846153846,1.3444976076555,4.81818181818182,209,130
"644",54,12.65,8,295,568,0.0130981206041739,1.92542372881356,1.92542372881356,1.70766041788743,76,62,157,0.462586462497711,2.13768115942029,1.34703196347032,4.6986301369863,219,138
"645",54,16.23,9,320,652,0.0127742946708464,2.0375,2.0375,1.74305761440016,82,72,166,0.45569908618927,2.07792207792208,1.34453781512605,4.48319327731092,238,154
"646",54,19.47,10,332,689,0.0125395843191497,2.07530120481928,2.07530120481928,1.78517932361576,84,75,173,0.442756980657578,2.08805031446541,1.33870967741935,4.375,248,159
"647",54,20.72,11,342,727,0.0124676304642349,2.12573099415205,2.12573099415205,1.80164285871487,87,78,177,0.454396992921829,2.07272727272727,1.34117647058824,4.30980392156863,255,165
"648",54,21.5,12,349,753,0.0123999604782136,2.15759312320917,2.15759312320917,1.78717874239867,88,78,183,0.424523204565048,2.10240963855422,1.33716475095785,4.24521072796935,261,166
"649",55,0.13,1,110,118,0.0196830692243536,1.07272727272727,1.07272727272727,1.0390487353936,31,22,57,0.75061047077179,2.07547169811321,1.39240506329114,6.9873417721519,79,53
"650",55,0.7,2,168,219,0.0156116338751069,1.30357142857143,1.30357142857143,1.47034935459318,48,36,84,0.596620202064514,2,1.4,6.13333333333333,120,84
"651",55,4.28,3,228,349,0.0134863590694799,1.53070175438596,1.53070175438596,1.60422072978353,65,50,113,0.516678810119629,1.98260869565217,1.39877300613497,5.42331288343558,163,115
"652",55,5.53,4,251,418,0.0133227091633466,1.66533864541833,1.66533864541833,1.6474960170823,71,55,125,0.489823937416077,1.99206349206349,1.39444444444444,5.13888888888889,180,126
"653",55,7.05,5,266,460,0.0130514966661938,1.72932330827068,1.72932330827068,1.67313771289973,76,61,129,0.493312805891037,1.94160583941606,1.4,5.00526315789474,190,137
"654",55,10.53,6,280,499,0.0127752176139273,1.78214285714286,1.78214285714286,1.72858464366927,78,64,138,0.503558278083801,1.97183098591549,1.38613861386139,4.9009900990099,202,142
"655",55,11.23,7,290,536,0.0127908364157022,1.84827586206897,1.84827586206897,1.70717751208509,79,65,146,0.48812198638916,2.01388888888889,1.37440758293839,4.76777251184834,211,144
"656",55,12.01,8,301,569,0.0126024363233666,1.89036544850498,1.89036544850498,1.67934574296259,80,66,155,0.46085849404335,2.06164383561644,1.36199095022624,4.64705882352941,221,146
"657",55,14.23,9,323,637,0.0122492933100013,1.97213622291022,1.97213622291022,1.74025230772926,85,70,168,0.457863986492157,2.08387096774194,1.35714285714286,4.52521008403361,238,155
"658",55,17.12,10,336,696,0.0123667377398721,2.07142857142857,2.07142857142857,1.74725013331742,86,75,175,0.436958074569702,2.08695652173913,1.344,4.376,250,161
"659",55,18.26,11,340,716,0.012424084678119,2.10588235294118,2.10588235294118,1.75191769590306,86,75,179,0.429503411054611,2.11180124223602,1.33858267716535,4.32677165354331,254,161
"660",55,21.5,12,349,753,0.0123999604782136,2.15759312320917,2.15759312320917,1.78717874239867,88,78,183,0.424523204565048,2.10240963855422,1.33716475095785,4.24521072796935,261,166
"661",56,3.48,1,144,158,0.0153457653457653,1.09722222222222,1.09722222222222,1.24917081106252,45,30,69,0.688811957836151,1.92,1.45454545454545,6.97979797979798,99,75
"662",56,4.62,2,165,231,0.0170731707317073,1.4,1.4,1.35434334401559,51,35,79,0.623151659965515,1.91860465116279,1.44736842105263,6.39473684210526,114,86
"663",56,5.87,3,201,306,0.0152238805970149,1.52238805970149,1.52238805970149,1.4791443903971,61,44,96,0.557515263557434,1.91428571428571,1.43571428571429,5.78571428571429,140,105
"664",56,7.39,4,228,355,0.0137182162454595,1.55701754385965,1.55701754385965,1.53948495318706,69,52,107,0.559742093086243,1.88429752066116,1.43396226415094,5.42767295597484,159,121
"665",56,9.61,5,268,446,0.0124657610822293,1.66417910447761,1.66417910447761,1.60623101949203,76,60,132,0.515250146389008,1.97058823529412,1.39583333333333,5.046875,192,136
"666",56,10.39,6,283,485,0.0121544746009072,1.71378091872792,1.71378091872792,1.59830301008864,77,60,146,0.501675009727478,2.06569343065693,1.37378640776699,4.87864077669903,206,137
"667",56,10.96,7,289,518,0.0124471357170319,1.7923875432526,1.7923875432526,1.71757942657735,78,62,149,0.485372066497803,2.06428571428571,1.3696682464455,4.83886255924171,211,140
"668",56,13.85,8,308,586,0.0123947713524261,1.9025974025974,1.9025974025974,1.70248983785168,80,66,162,0.479988127946854,2.10958904109589,1.35087719298246,4.6359649122807,228,146
"669",56,14.55,9,315,613,0.0123951066626226,1.94603174603175,1.94603174603175,1.7053084057448,81,67,167,0.440875977277756,2.12837837837838,1.34615384615385,4.57264957264957,234,148
"670",56,14.68,10,318,637,0.0126381366188521,2.00314465408805,2.00314465408805,1.71861450273058,81,67,170,0.416045874357224,2.14864864864865,1.34177215189873,4.53586497890295,237,148
"671",56,17.92,11,329,675,0.0125101934909927,2.0516717325228,2.0516717325228,1.76028004046815,83,71,175,0.41419917345047,2.13636363636364,1.33739837398374,4.41869918699187,246,154
"672",56,21.5,12,349,753,0.0123999604782136,2.15759312320917,2.15759312320917,1.78717874239867,88,78,183,0.424523204565048,2.10240963855422,1.33716475095785,4.24521072796935,261,166
"673",57,1.25,1,132,163,0.018852648623641,1.23484848484848,1.23484848484848,1.33070044194863,42,28,62,0.615510582923889,1.88571428571429,1.46666666666667,7.02222222222222,90,70
"674",57,2.77,2,188,245,0.013937876891569,1.3031914893617,1.3031914893617,1.37875802917873,60,41,87,0.568646371364594,1.86138613861386,1.46875,6.078125,128,101
"675",57,6.35,3,237,366,0.0130873203175284,1.54430379746835,1.54430379746835,1.5468933194576,72,55,110,0.556182682514191,1.86614173228346,1.43636363636364,5.43636363636364,165,127
"676",57,9.24,4,270,458,0.0126118683739502,1.6962962962963,1.6962962962963,1.58033402445162,76,62,132,0.502276360988617,1.95652173913043,1.39175257731959,5.02061855670103,194,138
"677",57,10.02,5,290,501,0.0119556138885575,1.72758620689655,1.72758620689655,1.60122658109005,79,66,145,0.515655338764191,2,1.37440758293839,4.78672985781991,211,145
"678",57,13.26,6,308,551,0.0116544693091924,1.78896103896104,1.78896103896104,1.64888298607661,83,70,155,0.495688408613205,2.01307189542484,1.36888888888889,4.59555555555556,225,153
"679",57,15.48,7,322,625,0.0120934192449836,1.94099378881988,1.94099378881988,1.70893773349032,85,72,165,0.456983059644699,2.05095541401274,1.35864978902954,4.50210970464135,237,157
"680",57,16.05,8,325,655,0.0124406457739791,2.01538461538462,2.01538461538462,1.75966203163863,86,74,165,0.455440849065781,2.03125,1.35983263598326,4.47280334728034,239,160
"681",57,16.18,9,330,678,0.0124896380215529,2.05454545454545,2.05454545454545,1.75819751113337,86,74,170,0.409166932106018,2.0625,1.35245901639344,4.41803278688525,244,160
"682",57,16.88,10,336,704,0.0125088841506752,2.0952380952381,2.0952380952381,1.76298072133719,87,75,174,0.430783122777939,2.07407407407407,1.34939759036145,4.37349397590361,249,162
"683",57,18.02,11,340,723,0.0125455491931286,2.12647058823529,2.12647058823529,1.76872581738239,87,75,178,0.414171606302261,2.09876543209877,1.34387351778656,4.33596837944664,253,162
"684",57,21.5,12,349,753,0.0123999604782136,2.15759312320917,2.15759312320917,1.78717874239867,88,78,183,0.424523204565048,2.10240963855422,1.33716475095785,4.24521072796935,261,166
"685",58,3.58,1,171,218,0.0149982800137599,1.27485380116959,1.27485380116959,1.32365427157769,51,39,81,0.601738095283508,1.9,1.425,6.25833333333333,120,90
"686",58,5.8,2,237,355,0.0126939855538869,1.49789029535865,1.49789029535865,1.52983034249232,70,54,113,0.565772652626038,1.91129032258065,1.41916167664671,5.40119760479042,167,124
"687",58,7.32,3,255,401,0.0123822757449436,1.57254901960784,1.57254901960784,1.58521642890439,75,59,121,0.542229175567627,1.90298507462687,1.41666666666667,5.22222222222222,180,134
"688",58,8.46,4,262,440,0.0128688836243456,1.6793893129771,1.6793893129771,1.61041994282894,76,60,126,0.511877596378326,1.92647058823529,1.40860215053763,5.10752688172043,186,136
"689",58,9.71,5,287,501,0.0122073048902317,1.74564459930314,1.74564459930314,1.68839756203013,81,65,141,0.49173903465271,1.96575342465753,1.39320388349515,4.89320388349515,206,146
"690",58,10.41,6,298,539,0.0121799652000994,1.80872483221477,1.80872483221477,1.70968414765228,82,66,150,0.490998923778534,2.01351351351351,1.37962962962963,4.76388888888889,216,148
"691",58,13.3,7,314,608,0.0123725605909526,1.93630573248408,1.93630573248408,1.71030465201746,83,70,161,0.458559662103653,2.05228758169935,1.35930735930736,4.58008658008658,231,153
"692",58,16.54,8,324,645,0.0123265680541222,1.99074074074074,1.99074074074074,1.75151132214959,85,73,166,0.455727458000183,2.05063291139241,1.35564853556485,4.48535564853557,239,158
"693",58,20.02,9,333,675,0.0122110061869098,2.02702702702703,2.02702702702703,1.77021950854512,86,76,171,0.448737472295761,2.05555555555556,1.34817813765182,4.38461538461539,247,162
"694",58,20.59,10,338,703,0.0123435113163486,2.07988165680473,2.07988165680473,1.80370624143701,87,78,173,0.454223811626434,2.04848484848485,1.34661354581673,4.35059760956175,251,165
"695",58,20.72,11,342,727,0.0124676304642349,2.12573099415205,2.12573099415205,1.80164285871487,87,78,177,0.454396992921829,2.07272727272727,1.34117647058824,4.30980392156863,255,165
"696",58,21.5,12,349,753,0.0123999604782136,2.15759312320917,2.15759312320917,1.78717874239867,88,78,183,0.424523204565048,2.10240963855422,1.33716475095785,4.24521072796935,261,166
"697",59,2.22,1,171,214,0.0147230822153423,1.25146198830409,1.25146198830409,1.28872700047602,51,39,81,0.66843169927597,1.9,1.425,6.475,120,90
"698",59,2.35,2,195,268,0.0141686492201956,1.37435897435897,1.37435897435897,1.32740931226583,56,40,99,0.623092532157898,2.03125,1.40287769784173,5.97841726618705,139,96
"699",59,3.49,3,206,313,0.0148235851290552,1.51941747572816,1.51941747572816,1.3907744490086,58,41,107,0.593386650085449,2.08080808080808,1.39189189189189,5.73648648648649,148,99
"700",59,4.19,4,227,363,0.0141514950684184,1.59911894273128,1.59911894273128,1.45918151682365,62,44,121,0.551430881023407,2.14150943396226,1.37575757575758,5.50909090909091,165,106
"701",59,4.76,5,240,408,0.0142259414225941,1.7,1.7,1.59736575724665,64,47,129,0.531973898410797,2.16216216216216,1.36363636363636,5.33522727272727,176,111
"702",59,5.54,6,254,446,0.0138806759826958,1.75590551181102,1.75590551181102,1.59355171379869,66,50,138,0.487183004617691,2.18965517241379,1.35106382978723,5.16489361702128,188,116
"703",59,6.79,7,273,498,0.0134130575307046,1.82417582417582,1.82417582417582,1.66247204936446,73,55,145,0.480572879314423,2.1328125,1.365,5.01,200,128
"704",59,10.03,8,288,543,0.0131387921022067,1.88541666666667,1.88541666666667,1.72653560736939,76,59,153,0.463537305593491,2.13333333333333,1.35849056603774,4.83962264150943,212,135
"705",59,11.55,9,302,581,0.0127829970737718,1.92384105960265,1.92384105960265,1.74215221597384,79,64,159,0.454320877790451,2.11188811188811,1.3542600896861,4.70403587443946,223,143
"706",59,15.13,10,328,666,0.0124188856567465,2.03048780487805,2.03048780487805,1.76957580454833,86,71,171,0.423197954893112,2.08917197452229,1.35537190082645,4.47520661157025,242,157
"707",59,18.02,11,340,723,0.0125455491931286,2.12647058823529,2.12647058823529,1.76872581738239,87,75,178,0.414171606302261,2.09876543209877,1.34387351778656,4.33596837944664,253,162
"708",59,21.5,12,349,753,0.0123999604782136,2.15759312320917,2.15759312320917,1.78717874239867,88,78,183,0.424523204565048,2.10240963855422,1.33716475095785,4.24521072796935,261,166
"709",60,1.52,1,120,123,0.0172268907563025,1.025,1.025,1.07664941419089,38,25,57,0.737590074539185,1.9047619047619,1.46341463414634,7.03658536585366,82,63
"710",60,3.74,2,207,278,0.013038788049341,1.34299516908213,1.34299516908213,1.35943614009503,61,46,100,0.607939481735229,1.93457943925234,1.41780821917808,5.79452054794521,146,107
"711",60,4.52,3,227,334,0.0130209348563409,1.47136563876652,1.47136563876652,1.37910796165806,63,49,115,0.592688798904419,2.02678571428571,1.38414634146341,5.51219512195122,164,112
"712",60,7.41,4,267,437,0.0123060460139112,1.63670411985019,1.63670411985019,1.51697767634563,72,56,139,0.55345892906189,2.0859375,1.36923076923077,5.09230769230769,195,128
"713",60,7.54,5,273,469,0.01263197586727,1.71794871794872,1.71794871794872,1.53572343340369,72,57,144,0.51018363237381,2.11627906976744,1.35820895522388,5.00497512437811,201,129
"714",60,8.68,6,278,495,0.0128561410799159,1.78057553956835,1.78057553956835,1.54915675108478,72,57,149,0.509172558784485,2.15503875968992,1.3495145631068,4.92718446601942,206,129
"715",60,9.93,7,298,544,0.0122929518902673,1.8255033557047,1.8255033557047,1.60478836962823,77,61,160,0.494529247283936,2.15942028985507,1.34841628959276,4.75113122171946,221,138
"716",60,10.63,8,304,574,0.0124630884141046,1.88815789473684,1.88815789473684,1.62092034549591,78,62,164,0.459918200969696,2.17142857142857,1.34513274336283,4.69469026548673,226,140
"717",60,11.2,9,307,605,0.0128802878371761,1.97068403908795,1.97068403908795,1.70057340745181,79,64,164,0.449675589799881,2.14685314685315,1.34649122807018,4.66228070175439,228,143
"718",60,14.78,10,331,686,0.0125606518355763,2.07250755287009,2.07250755287009,1.73244283442768,85,72,174,0.430382937192917,2.10828025477707,1.34552845528455,4.42276422764228,246,157
"719",60,18.02,11,340,723,0.0125455491931286,2.12647058823529,2.12647058823529,1.76872581738239,87,75,178,0.414171606302261,2.09876543209877,1.34387351778656,4.33596837944664,253,162
"720",60,21.5,12,349,753,0.0123999604782136,2.15759312320917,2.15759312320917,1.78717874239867,88,78,183,0.424523204565048,2.10240963855422,1.33716475095785,4.24521072796935,261,166
"721",61,2.89,1,163,202,0.015299553131864,1.23926380368098,1.23926380368098,1.32935663673885,48,35,80,0.611067533493042,1.96385542168675,1.41739130434783,6.6,115,83
"722",61,4.03,2,189,274,0.0154227175503771,1.44973544973545,1.44973544973545,1.34873938328823,55,39,95,0.562709808349609,2.01063829787234,1.41044776119403,6.08955223880597,134,94
"723",61,4.73,3,213,333,0.0147488705819825,1.56338028169014,1.56338028169014,1.4197101905903,58,43,112,0.543732881546021,2.10891089108911,1.3741935483871,5.63870967741935,155,101
"724",61,6.25,4,247,385,0.012672393930417,1.5587044534413,1.5587044534413,1.48888111441597,68,49,130,0.538043439388275,2.11111111111111,1.37988826815642,5.26256983240223,179,117
"725",61,6.82,5,256,430,0.0131740196078431,1.6796875,1.6796875,1.61812195684321,69,55,132,0.532479703426361,2.06451612903226,1.36898395721925,5.11764705882353,187,124
"726",61,9.04,6,279,503,0.0129702689461334,1.80286738351254,1.80286738351254,1.66073975111178,74,59,146,0.486828505992889,2.09774436090226,1.3609756097561,4.90731707317073,205,133
"727",61,10.29,7,294,552,0.0128160479208748,1.87755102040816,1.87755102040816,1.70697925292022,78,64,152,0.464865893125534,2.07042253521127,1.36111111111111,4.81481481481481,216,142
"728",61,13.87,8,319,636,0.0125391849529781,1.99373040752351,1.99373040752351,1.7470302033477,84,72,163,0.477837860584259,2.0448717948718,1.35744680851064,4.54042553191489,235,156
"729",61,17.35,9,328,666,0.0124188856567465,2.03048780487805,2.03048780487805,1.76537920449921,85,75,168,0.483254641294479,2.05,1.34979423868313,4.43621399176955,243,160
"730",61,20.59,10,338,703,0.0123435113163486,2.07988165680473,2.07988165680473,1.80370624143701,87,78,173,0.454223811626434,2.04848484848485,1.34661354581673,4.35059760956175,251,165
"731",61,21.37,11,346,731,0.0122476334087292,2.11271676300578,2.11271676300578,1.78827717377754,88,78,180,0.458441913127899,2.08433734939759,1.34108527131783,4.27519379844961,258,166
"732",61,21.5,12,349,753,0.0123999604782136,2.15759312320917,2.15759312320917,1.78717874239867,88,78,183,0.424523204565048,2.10240963855422,1.33716475095785,4.24521072796935,261,166
"733",62,0.57,1,142,160,0.0159824193387274,1.12676056338028,1.12676056338028,1.50917260456006,45,31,66,0.703574180603027,1.86842105263158,1.4639175257732,6.31958762886598,97,76
"734",62,4.15,2,212,302,0.0135026379325762,1.42452830188679,1.42452830188679,1.61861644042937,63,50,99,0.548649191856384,1.87610619469027,1.42281879194631,5.56375838926174,149,113
"735",62,4.93,3,238,361,0.0128000567315534,1.51680672268908,1.51680672268908,1.60203353316498,69,54,115,0.532753765583038,1.9349593495935,1.40828402366864,5.37869822485207,169,123
"736",62,5.06,4,248,398,0.0129946454224892,1.60483870967742,1.60483870967742,1.56961313168387,69,54,125,0.522388994693756,2.01626016260163,1.3854748603352,5.22346368715084,179,123
"737",62,8.54,5,260,441,0.0130977130977131,1.69615384615385,1.69615384615385,1.61314479164966,70,58,132,0.508044540882111,2.03125,1.36842105263158,5.06315789473684,190,128
"738",62,10.06,6,273,479,0.0129013143719026,1.75457875457875,1.75457875457875,1.64013861928386,74,63,136,0.510580062866211,1.99270072992701,1.37185929648241,4.95979899497487,199,137
"739",62,11.31,7,292,534,0.0125688462081627,1.82876712328767,1.82876712328767,1.68934096840272,79,65,148,0.498323708772659,2.02777777777778,1.37089201877934,4.75586854460094,213,144
"740",62,14.2,8,314,601,0.0122301133473067,1.9140127388535,1.9140127388535,1.69353316713176,82,71,161,0.475210428237915,2.05228758169935,1.35344827586207,4.5301724137931,232,153
"741",62,14.9,9,321,631,0.0122858255451713,1.96573208722741,1.96573208722741,1.69549869777969,83,72,166,0.445485651493073,2.07096774193548,1.34873949579832,4.46638655462185,238,155
"742",62,18.14,10,335,674,0.0120475466976495,2.01194029850746,2.01194029850746,1.73715758386693,87,76,172,0.432860165834427,2.05521472392638,1.3508064516129,4.34677419354839,248,163
"743",62,19.28,11,338,695,0.0122030446157358,2.05621301775148,2.05621301775148,1.754077781403,87,76,175,0.441011279821396,2.07361963190184,1.34661354581673,4.31075697211155,251,163
"744",62,21.5,12,349,753,0.0123999604782136,2.15759312320917,2.15759312320917,1.78717874239867,88,78,183,0.424523204565048,2.10240963855422,1.33716475095785,4.24521072796935,261,166
"745",63,1.25,1,132,163,0.018852648623641,1.23484848484848,1.23484848484848,1.33070044194863,42,28,62,0.615510582923889,1.88571428571429,1.46666666666667,7.02222222222222,90,70
"746",63,4.49,2,204,269,0.0129914034579349,1.31862745098039,1.31862745098039,1.53740462544364,61,43,100,0.601083517074585,1.96153846153846,1.42657342657343,5.88111888111888,143,104
"747",63,8.07,3,250,389,0.0124979919678715,1.556,1.556,1.63709260468661,74,55,121,0.529784381389618,1.93798449612403,1.42045454545455,5.30113636363636,176,129
"748",63,8.2,4,261,431,0.0127026230474506,1.65134099616858,1.65134099616858,1.61676220794427,75,56,130,0.524044275283813,1.99236641221374,1.40322580645161,5.12365591397849,186,131
"749",63,8.9,5,274,474,0.0126734579289324,1.72992700729927,1.72992700729927,1.64545076550125,78,59,137,0.514856934547424,2,1.39795918367347,4.94897959183673,196,137
"750",63,11.12,6,296,547,0.0125286303252405,1.84797297297297,1.84797297297297,1.72051616956986,81,64,151,0.493394285440445,2.04137931034483,1.37674418604651,4.78139534883721,215,145
"751",63,11.69,7,307,582,0.0123906240020438,1.8957654723127,1.8957654723127,1.76827407551897,83,66,158,0.474533796310425,2.06040268456376,1.37053571428571,4.6875,224,149
"752",63,15.17,8,317,618,0.0123387773030388,1.94952681388013,1.94952681388013,1.79070833633939,84,69,164,0.485853224992752,2.0718954248366,1.36051502145923,4.57081545064378,233,153
"753",63,16.31,9,320,638,0.0125,1.99375,1.99375,1.80077665110414,84,70,166,0.476732283830643,2.07792207792208,1.35593220338983,4.52966101694915,236,154
"754",63,17.83,10,329,670,0.0124175253910594,2.03647416413374,2.03647416413374,1.81833026693653,86,74,169,0.471828937530518,2.05625,1.35390946502058,4.45679012345679,243,160
"755",63,18.61,11,337,699,0.0123463331920305,2.07418397626113,2.07418397626113,1.79914578954811,87,74,176,0.450145363807678,2.09316770186335,1.348,4.376,250,161
"756",63,21.5,12,349,753,0.0123999604782136,2.15759312320917,2.15759312320917,1.78717874239867,88,78,183,0.424523204565048,2.10240963855422,1.33716475095785,4.24521072796935,261,166
"757",64,3.48,1,144,158,0.0153457653457653,1.09722222222222,1.09722222222222,1.24917081106252,45,30,69,0.688811957836151,1.92,1.45454545454545,6.97979797979798,99,75
"758",64,4.26,2,185,233,0.013689776733255,1.25945945945946,1.25945945945946,1.28713994722152,55,37,93,0.683195471763611,2.01086956521739,1.42307692307692,6.02307692307692,130,92
"759",64,5.78,3,213,286,0.0126671981574984,1.34272300469484,1.34272300469484,1.3571447684114,61,46,106,0.624651551246643,1.99065420560748,1.40131578947368,5.63157894736842,152,107
"760",64,6.92,4,224,337,0.0134929532351057,1.50446428571429,1.50446428571429,1.44368563230342,64,48,112,0.583935678005219,2,1.4,5.40625,160,112
"761",64,7.05,5,233,369,0.0136525085096937,1.58369098712446,1.58369098712446,1.45899653489954,64,48,121,0.571081280708313,2.08035714285714,1.37869822485207,5.29585798816568,169,112
"762",64,9.27,6,263,453,0.0131483470234813,1.72243346007605,1.72243346007605,1.52880821677145,69,54,140,0.49845278263092,2.13821138211382,1.35567010309278,5.04123711340206,194,123
"763",64,10.52,7,287,510,0.0124265977924515,1.77700348432056,1.77700348432056,1.60888763550322,77,60,150,0.476624310016632,2.0948905109489,1.36666666666667,4.81904761904762,210,137
"764",64,13.41,8,309,578,0.0121464296221578,1.8705501618123,1.8705501618123,1.62130576336654,79,64,166,0.464862197637558,2.16083916083916,1.34347826086957,4.61739130434783,230,143
"765",64,16.65,9,320,618,0.0121081504702194,1.93125,1.93125,1.68111143000976,81,68,171,0.452494502067566,2.14765100671141,1.33891213389121,4.49372384937239,239,149
"766",64,20.23,10,340,700,0.0121464515009544,2.05882352941176,2.05882352941176,1.73486315470499,86,75,179,0.425655126571655,2.11180124223603,1.33858267716535,4.31102362204724,254,161
"767",64,20.8,11,343,727,0.0123949329105076,2.11953352769679,2.11953352769679,1.78112268408736,87,77,179,0.410857290029526,2.09146341463415,1.33984375,4.28515625,256,164
"768",64,21.5,12,349,753,0.0123999604782136,2.15759312320917,2.15759312320917,1.78717874239867,88,78,183,0.424523204565048,2.10240963855422,1.33716475095785,4.24521072796935,261,166
"769",65,0.13,1,110,118,0.0196830692243536,1.07272727272727,1.07272727272727,1.0390487353936,31,22,57,0.75061047077179,2.07547169811321,1.39240506329114,6.9873417721519,79,53
"770",65,1.27,2,147,201,0.0187307799832262,1.36734693877551,1.36734693877551,1.24949020263686,43,31,73,0.598648548126221,1.98648648648649,1.41346153846154,6.5,104,74
"771",65,1.84,3,180,273,0.0169459962756052,1.51666666666667,1.51666666666667,1.54350051361239,51,40,89,0.564223289489746,1.97802197802198,1.3953488372093,6,129,91
"772",65,4.06,4,221,362,0.0148909913615796,1.63800904977376,1.63800904977376,1.59147153080797,61,45,115,0.560495018959045,2.08490566037736,1.38125,5.55,160,106
"773",65,6.95,5,255,455,0.0140497143739386,1.7843137254902,1.7843137254902,1.67584410543387,68,53,134,0.516145408153534,2.10743801652893,1.36363636363636,5.1283422459893,187,121
"774",65,10.53,6,293,548,0.0128103230632568,1.87030716723549,1.87030716723549,1.71409078398382,77,64,152,0.494597136974335,2.07801418439716,1.35648148148148,4.75462962962963,216,141
"775",65,11.31,7,301,578,0.0128017718715393,1.9202657807309,1.9202657807309,1.6917625600597,78,65,158,0.490485936403275,2.10489510489511,1.34977578475336,4.66816143497758,223,143
"776",65,14.55,8,313,620,0.0126976325059392,1.98083067092652,1.98083067092652,1.73659854324103,81,68,164,0.477297127246857,2.1006711409396,1.34913793103448,4.54310344827586,232,149
"777",65,18.03,9,323,654,0.0125761975270657,2.02476780185758,2.02476780185758,1.74805107969038,82,72,169,0.473287224769592,2.0974025974026,1.3402489626556,4.44398340248963,241,154
"778",65,19.28,10,335,694,0.0124050406649388,2.07164179104478,2.07164179104478,1.76279126217652,85,74,176,0.429715603590012,2.10691823899371,1.34,4.348,250,159
"779",65,20.8,11,343,727,0.0123949329105076,2.11953352769679,2.11953352769679,1.78112268408736,87,77,179,0.410857290029526,2.09146341463415,1.33984375,4.28515625,256,164
"780",65,21.5,12,349,753,0.0123999604782136,2.15759312320917,2.15759312320917,1.78717874239867,88,78,183,0.424523204565048,2.10240963855422,1.33716475095785,4.24521072796935,261,166
"781",66,0.13,1,110,118,0.0196830692243536,1.07272727272727,1.07272727272727,1.0390487353936,31,22,57,0.75061047077179,2.07547169811321,1.39240506329114,6.9873417721519,79,53
"782",66,2.35,2,195,268,0.0141686492201956,1.37435897435897,1.37435897435897,1.32740931226583,56,40,99,0.623092532157898,2.03125,1.40287769784173,5.97841726618705,139,96
"783",66,3.49,3,206,313,0.0148235851290552,1.51941747572816,1.51941747572816,1.3907744490086,58,41,107,0.593386650085449,2.08080808080808,1.39189189189189,5.73648648648649,148,99
"784",66,6.73,4,230,374,0.0142016328080501,1.62608695652174,1.62608695652174,1.54418222998865,63,48,119,0.53696483373642,2.07207207207207,1.37724550898204,5.35928143712575,167,111
"785",66,7.3,5,244,418,0.0140997099102746,1.71311475409836,1.71311475409836,1.68547122635503,66,50,128,0.536051154136658,2.10344827586207,1.37078651685393,5.21348314606742,178,116
"786",66,10.88,6,285,518,0.0127996046454164,1.81754385964912,1.81754385964912,1.75283692472236,78,61,146,0.473518967628479,2.05035971223022,1.3768115942029,4.8743961352657,207,139
"787",66,13.77,7,306,590,0.0126433086895961,1.9281045751634,1.9281045751634,1.75953913283549,80,67,159,0.490710973739624,2.08163265306122,1.35398230088496,4.62389380530973,226,147
"788",66,14.55,8,313,620,0.0126976325059392,1.98083067092652,1.98083067092652,1.73659854324103,81,68,164,0.477297127246857,2.1006711409396,1.34913793103448,4.54310344827586,232,149
"789",66,15.8,9,326,662,0.0124964605946201,2.03067484662577,2.03067484662577,1.75157316799638,84,70,172,0.44989550113678,2.11688311688312,1.34710743801653,4.44628099173554,242,154
"790",66,19.28,10,335,694,0.0124050406649388,2.07164179104478,2.07164179104478,1.76279126217652,85,74,176,0.429715603590012,2.10691823899371,1.34,4.348,250,159
"791",66,20.8,11,343,727,0.0123949329105076,2.11953352769679,2.11953352769679,1.78112268408736,87,77,179,0.410857290029526,2.09146341463415,1.33984375,4.28515625,256,164
"792",66,21.5,12,349,753,0.0123999604782136,2.15759312320917,2.15759312320917,1.78717874239867,88,78,183,0.424523204565048,2.10240963855422,1.33716475095785,4.24521072796935,261,166
"793",67,0.7,1,144,151,0.0146658896658897,1.04861111111111,1.04861111111111,1.16294760117179,43,26,75,0.720012247562408,2.08695652173913,1.42574257425743,6.81188118811881,101,69
"794",67,2.22,2,193,223,0.0120358376511226,1.15544041450777,1.15544041450777,1.26060390648279,58,34,101,0.645619213581085,2.09782608695652,1.42962962962963,5.98518518518518,135,92
"795",67,5.8,3,236,340,0.0122610890732059,1.44067796610169,1.44067796610169,1.48124002165986,70,50,116,0.564156591892242,1.96666666666667,1.42168674698795,5.48795180722892,166,120
"796",67,9.28,4,253,396,0.0124223602484472,1.56521739130435,1.56521739130435,1.55881964168054,73,55,125,0.553550004959106,1.9765625,1.40555555555556,5.23888888888889,180,128
"797",67,9.41,5,262,437,0.0127811412359978,1.66793893129771,1.66793893129771,1.57452371346689,74,56,132,0.50940465927124,2.01538461538462,1.3936170212766,5.10106382978723,188,130
"798",67,12.3,6,289,518,0.0124471357170319,1.7923875432526,1.7923875432526,1.62377593374346,78,64,147,0.479703634977341,2.03521126760563,1.3696682464455,4.7914691943128,211,142
"799",67,13.44,7,294,550,0.0127696129646398,1.87074829931973,1.87074829931973,1.63795930061315,78,65,151,0.460284322500229,2.05594405594406,1.36111111111111,4.70833333333333,216,143
"800",67,14.69,8,308,593,0.0125428317610728,1.92532467532468,1.92532467532468,1.67459372127932,81,68,159,0.455249398946762,2.06711409395973,1.3568281938326,4.5726872246696,227,149
"801",67,15.26,9,316,628,0.0126180429977898,1.9873417721519,1.9873417721519,1.72592493308201,82,72,162,0.451029986143112,2.05194805194805,1.35042735042735,4.49145299145299,234,154
"802",67,16.04,10,325,655,0.0124406457739791,2.01538461538462,2.01538461538462,1.70972517679519,83,72,170,0.459674805402756,2.09677419354839,1.34297520661157,4.41322314049587,242,155
"803",67,19.28,11,338,695,0.0122030446157358,2.05621301775148,2.05621301775148,1.754077781403,87,76,175,0.441011279821396,2.07361963190184,1.34661354581673,4.31075697211155,251,163
"804",67,21.5,12,349,753,0.0123999604782136,2.15759312320917,2.15759312320917,1.78717874239867,88,78,183,0.424523204565048,2.10240963855422,1.33716475095785,4.24521072796935,261,166
"805",68,1.25,1,132,163,0.018852648623641,1.23484848484848,1.23484848484848,1.33070044194863,42,28,62,0.615510582923889,1.88571428571429,1.46666666666667,7.02222222222222,90,70
"806",68,4.14,2,200,287,0.0144221105527638,1.435,1.435,1.41557906602171,58,42,100,0.558917820453644,2,1.40845070422535,6.06338028169014,142,100
"807",68,4.27,3,219,335,0.0140337648192367,1.5296803652968,1.5296803652968,1.45947726289366,62,47,110,0.532140791416168,2.00917431192661,1.39490445859873,5.69426751592357,157,109
"808",68,7.75,4,244,388,0.0130877690076233,1.59016393442623,1.59016393442623,1.49809611734948,68,51,125,0.545983195304871,2.05042016806723,1.38636363636364,5.29545454545455,176,119
"809",68,9.97,5,278,482,0.0125185050515544,1.73381294964029,1.73381294964029,1.58514894018343,74,60,144,0.503419816493988,2.07462686567164,1.36274509803922,4.94607843137255,204,134
"810",68,10.75,6,289,514,0.0123510188389081,1.77854671280277,1.77854671280277,1.57358922848668,75,60,154,0.485696166753769,2.14074074074074,1.35046728971963,4.82242990654206,214,135
"811",68,14.33,7,315,603,0.0121929026387625,1.91428571428571,1.91428571428571,1.66312654368035,81,69,165,0.485254764556885,2.1,1.34615384615385,4.54273504273504,234,150
"812",68,15.03,8,321,633,0.0123247663551402,1.97196261682243,1.97196261682243,1.68397885918592,82,70,169,0.458467841148376,2.11184210526316,1.34309623430962,4.49372384937239,239,152
"813",68,16.17,9,327,656,0.0123074613984728,2.00611620795107,2.00611620795107,1.69198768543842,82,70,175,0.470943629741669,2.15131578947368,1.33469387755102,4.42448979591837,245,152
"814",68,17.69,10,337,690,0.0121873675286138,2.04747774480712,2.04747774480712,1.7175494375573,85,73,179,0.44403800368309,2.13291139240506,1.33730158730159,4.3531746031746,252,158
"815",68,20.93,11,346,727,0.0121806148948647,2.10115606936416,2.10115606936416,1.75428805533464,87,76,183,0.430474996566772,2.12269938650307,1.33590733590734,4.27027027027027,259,163
"816",68,21.5,12,349,753,0.0123999604782136,2.15759312320917,2.15759312320917,1.78717874239867,88,78,183,0.424523204565048,2.10240963855422,1.33716475095785,4.24521072796935,261,166
"817",69,1.25,1,132,163,0.018852648623641,1.23484848484848,1.23484848484848,1.33070044194863,42,28,62,0.615510582923889,1.88571428571429,1.46666666666667,7.02222222222222,90,70
"818",69,1.38,2,167,227,0.0163768847846476,1.35928143712575,1.35928143712575,1.33233312153239,50,36,81,0.590929448604584,1.94186046511628,1.42735042735043,6.41880341880342,117,86
"819",69,4.62,3,218,317,0.0134021054411703,1.45412844036697,1.45412844036697,1.52138126587752,63,47,108,0.593612253665924,1.98181818181818,1.40645161290323,5.65161290322581,155,110
"820",69,5.4,4,240,366,0.0127615062761506,1.525,1.525,1.52924766166047,67,49,124,0.572419285774231,2.06896551724138,1.38728323699422,5.2485549132948,173,116
"821",69,6.54,5,248,399,0.0130272952853598,1.60887096774194,1.60887096774194,1.57652376736602,68,51,129,0.525951445102692,2.08403361344538,1.37777777777778,5.12222222222222,180,119
"822",69,7.11,6,257,441,0.0134058852140078,1.715953307393,1.715953307393,1.69836389161244,71,53,133,0.517690658569336,2.07258064516129,1.38172043010753,5.03225806451613,186,124
"823",69,10,7,284,511,0.012715871198925,1.79929577464789,1.79929577464789,1.69219228582548,76,58,150,0.479758441448212,2.11940298507463,1.36538461538462,4.77884615384615,208,134
"824",69,11.52,8,299,550,0.0123454018989473,1.83946488294314,1.83946488294314,1.71632729328334,79,64,156,0.482095837593079,2.09090909090909,1.35909090909091,4.66818181818182,220,143
"825",69,12.22,9,306,581,0.0124504446587378,1.89869281045752,1.89869281045752,1.70592851146505,80,65,161,0.447693943977356,2.11034482758621,1.35398230088496,4.61504424778761,226,145
"826",69,15.8,10,328,665,0.0124002386812859,2.02743902439024,2.02743902439024,1.73040571627861,86,73,169,0.448179066181183,2.06289308176101,1.35537190082645,4.40082644628099,242,159
"827",69,18.02,11,340,723,0.0125455491931286,2.12647058823529,2.12647058823529,1.76872581738239,87,75,178,0.414171606302261,2.09876543209877,1.34387351778656,4.33596837944664,253,162
"828",69,21.5,12,349,753,0.0123999604782136,2.15759312320917,2.15759312320917,1.78717874239867,88,78,183,0.424523204565048,2.10240963855422,1.33716475095785,4.24521072796935,261,166
"829",70,0.7,1,144,151,0.0146658896658897,1.04861111111111,1.04861111111111,1.16294760117179,43,26,75,0.720012247562408,2.08695652173913,1.42574257425743,6.81188118811881,101,69
"830",70,1.27,2,184,236,0.0140175813732478,1.28260869565217,1.28260869565217,1.52627763653964,55,38,91,0.585858941078186,1.97849462365591,1.42635658914729,5.96124031007752,129,93
"831",70,3.49,3,227,338,0.0131768741959378,1.48898678414097,1.48898678414097,1.54672911257815,64,46,117,0.557390332221985,2.06363636363636,1.39263803680982,5.57668711656442,163,110
"832",70,4.74,4,251,404,0.0128764940239044,1.60956175298805,1.60956175298805,1.70361283353917,71,54,126,0.531020224094391,2.008,1.39444444444444,5.35555555555556,180,125
"833",70,8.32,5,289,505,0.0121347558631296,1.74740484429066,1.74740484429066,1.73611738477665,80,63,146,0.512740015983582,2.02097902097902,1.38277511961723,4.88995215311005,209,143
"834",70,11.21,6,304,576,0.0125065138092757,1.89473684210526,1.89473684210526,1.73186407551469,81,69,154,0.507259428501129,2.02666666666667,1.36322869955157,4.68609865470852,223,150
"835",70,12.73,7,314,613,0.0124743086221282,1.95222929936306,1.95222929936306,1.74400452757147,84,72,158,0.491360425949097,2.01282051282051,1.36521739130435,4.6,230,156
"836",70,16.21,8,324,644,0.0123074570958988,1.98765432098765,1.98765432098765,1.7611366998713,85,75,164,0.477853357791901,2.025,1.35564853556485,4.48953974895398,239,160
"837",70,17.35,9,328,666,0.0124188856567465,2.03048780487805,2.03048780487805,1.76537920449921,85,75,168,0.483254641294479,2.05,1.34979423868313,4.43621399176955,243,160
"838",70,17.48,10,332,690,0.0125577840061151,2.07831325301205,2.07831325301205,1.7646184307219,85,75,172,0.459378302097321,2.075,1.34412955465587,4.39271255060729,247,160
"839",70,20.72,11,342,727,0.0124676304642349,2.12573099415205,2.12573099415205,1.80164285871487,87,78,177,0.454396992921829,2.07272727272727,1.34117647058824,4.30980392156863,255,165
"840",70,21.5,12,349,753,0.0123999604782136,2.15759312320917,2.15759312320917,1.78717874239867,88,78,183,0.424523204565048,2.10240963855422,1.33716475095785,4.24521072796935,261,166
"841",71,2.89,1,163,202,0.015299553131864,1.23926380368098,1.23926380368098,1.32935663673885,48,35,80,0.611067533493042,1.96385542168675,1.41739130434783,6.6,115,83
"842",71,3.67,2,201,283,0.0140796019900498,1.40796019900498,1.40796019900498,1.36853741443069,57,43,101,0.595375120639801,2.01,1.39583333333333,5.84722222222222,144,100
"843",71,4.24,3,227,349,0.0136057073798292,1.5374449339207,1.5374449339207,1.59933771184932,65,48,114,0.541567862033844,2.00884955752212,1.40123456790123,5.45679012345679,162,113
"844",71,4.94,4,244,392,0.0132226944613101,1.60655737704918,1.60655737704918,1.57115232634993,67,51,126,0.520232439041138,2.06779661016949,1.37853107344633,5.22033898305085,177,118
"845",71,6.08,5,249,423,0.013699961134862,1.69879518072289,1.69879518072289,1.58429418290203,67,51,131,0.504638731479645,2.11016949152542,1.36813186813187,5.12637362637363,182,118
"846",71,9.32,6,274,472,0.0126199834229031,1.72262773722628,1.72262773722628,1.66466806064265,73,57,144,0.494265735149384,2.10769230769231,1.36318407960199,4.86567164179105,201,130
"847",71,9.45,7,278,502,0.0130379450951874,1.80575539568345,1.80575539568345,1.66618261842207,73,58,147,0.483141213655472,2.12213740458015,1.35609756097561,4.81951219512195,205,131
"848",71,12.93,8,292,541,0.0127336063644495,1.8527397260274,1.8527397260274,1.6827905551965,75,61,156,0.462315648794174,2.14705882352941,1.34562211981567,4.67741935483871,217,136
"849",71,14.45,9,306,575,0.0123218686381656,1.87908496732026,1.87908496732026,1.71093302996599,78,65,163,0.461001098155975,2.13986013986014,1.34210526315789,4.58771929824561,228,143
"850",71,18.03,10,327,657,0.0123262227725559,2.00917431192661,2.00917431192661,1.73621369174931,84,74,169,0.457758456468582,2.06962025316456,1.34567901234568,4.39094650205761,243,158
"851",71,20.25,11,339,717,0.0125150547206367,2.11504424778761,2.11504424778761,1.7706587744849,85,76,178,0.435257375240326,2.1055900621118,1.33464566929134,4.30708661417323,254,161
"852",71,21.5,12,349,753,0.0123999604782136,2.15759312320917,2.15759312320917,1.78717874239867,88,78,183,0.424523204565048,2.10240963855422,1.33716475095785,4.24521072796935,261,166
"853",72,2.22,1,171,214,0.0147230822153423,1.25146198830409,1.25146198830409,1.28872700047602,51,39,81,0.66843169927597,1.9,1.425,6.475,120,90
"854",72,2.92,2,204,282,0.0136192407997682,1.38235294117647,1.38235294117647,1.3530572721254,58,42,104,0.59000426530838,2.04,1.3972602739726,5.93835616438356,146,100
"855",72,6.16,3,231,344,0.0129493694711086,1.48917748917749,1.48917748917749,1.48429164697414,63,49,119,0.559284627437592,2.0625,1.375,5.49404761904762,168,112
"856",72,6.94,4,248,391,0.0127660963823952,1.57661290322581,1.57661290322581,1.49080305942275,65,52,131,0.531377375125885,2.11965811965812,1.3551912568306,5.24590163934426,183,117
"857",72,10.52,5,285,496,0.0122559920929083,1.74035087719298,1.74035087719298,1.61688106283779,76,62,147,0.499847590923309,2.06521739130435,1.36363636363636,4.86124401913876,209,138
"858",72,12.04,6,300,537,0.0119732441471572,1.79,1.79,1.66497073829861,80,66,154,0.451317548751831,2.05479452054794,1.36363636363636,4.72272727272727,220,146
"859",72,15.52,7,312,577,0.0118929837579355,1.84935897435897,1.84935897435897,1.70164238788927,82,69,161,0.448262214660645,2.06622516556291,1.35652173913043,4.59130434782609,230,151
"860",72,15.65,8,317,607,0.0121191550533083,1.91482649842271,1.91482649842271,1.69803168119661,82,69,166,0.471887528896332,2.09933774834437,1.34893617021277,4.54042553191489,235,151
"861",72,18.54,9,332,669,0.012175590579842,2.01506024096386,2.01506024096386,1.71367077157497,84,74,174,0.456681907176971,2.10126582278481,1.33870967741935,4.37903225806452,248,158
"862",72,19.11,10,336,698,0.0124022743425728,2.07738095238095,2.07738095238095,1.76231706244067,85,76,175,0.440520823001862,2.08695652173913,1.33864541832669,4.34262948207171,251,161
"863",72,20.25,11,339,717,0.0125150547206367,2.11504424778761,2.11504424778761,1.7706587744849,85,76,178,0.435257375240326,2.1055900621118,1.33464566929134,4.30708661417323,254,161
"864",72,21.5,12,349,753,0.0123999604782136,2.15759312320917,2.15759312320917,1.78717874239867,88,78,183,0.424523204565048,2.10240963855422,1.33716475095785,4.24521072796935,261,166
"865",73,3.48,1,144,158,0.0153457653457653,1.09722222222222,1.09722222222222,1.24917081106252,45,30,69,0.688811957836151,1.92,1.45454545454545,6.97979797979798,99,75
"866",73,5.7,2,211,290,0.0130895960279847,1.37440758293839,1.37440758293839,1.39450721028946,61,45,105,0.627865612506866,1.99056603773585,1.40666666666667,5.81333333333333,150,106
"867",73,6.95,3,244,365,0.012311947648924,1.49590163934426,1.49590163934426,1.57039010588324,71,53,120,0.592989385128021,1.96774193548387,1.41040462427746,5.39306358381503,173,124
"868",73,7.52,4,256,409,0.012530637254902,1.59765625,1.59765625,1.73687474271733,72,56,128,0.56175833940506,2,1.39130434782609,5.2445652173913,184,128
"869",73,8.66,5,260,442,0.0131274131274131,1.7,1.7,1.71930390908195,72,57,131,0.521060645580292,2.01550387596899,1.38297872340426,5.15957446808511,188,129
"870",73,12.24,6,294,534,0.0123981333147594,1.81632653061224,1.81632653061224,1.76348856626786,80,66,148,0.501162528991699,2.01369863013699,1.37383177570093,4.79439252336449,214,146
"871",73,12.37,7,300,561,0.0125083612040134,1.87,1.87,1.75378395634861,80,66,154,0.489897429943085,2.05479452054794,1.36363636363636,4.72272727272727,220,146
"872",73,13.89,8,310,598,0.0124856456832655,1.92903225806452,1.92903225806452,1.77689115180487,83,70,157,0.455977886915207,2.02614379084967,1.36563876651982,4.63876651982379,227,153
"873",73,16.78,9,326,662,0.0124964605946201,2.03067484662577,2.03067484662577,1.76388384853811,84,74,168,0.445623904466629,2.06329113924051,1.34710743801653,4.43801652892562,242,158
"874",73,17.56,10,334,689,0.0123896351441262,2.06287425149701,2.06287425149701,1.74554213299748,85,74,175,0.421163141727448,2.10062893081761,1.34136546184739,4.36947791164659,249,159
"875",73,18.26,11,340,716,0.012424084678119,2.10588235294118,2.10588235294118,1.75191769590306,86,75,179,0.429503411054611,2.11180124223602,1.33858267716535,4.32677165354331,254,161
"876",73,21.5,12,349,753,0.0123999604782136,2.15759312320917,2.15759312320917,1.78717874239867,88,78,183,0.424523204565048,2.10240963855422,1.33716475095785,4.24521072796935,261,166
"877",74,0.13,1,110,118,0.0196830692243536,1.07272727272727,1.07272727272727,1.0390487353936,31,22,57,0.75061047077179,2.07547169811321,1.39240506329114,6.9873417721519,79,53
"878",74,1.27,2,147,201,0.0187307799832262,1.36734693877551,1.36734693877551,1.24949020263686,43,31,73,0.598648548126221,1.98648648648649,1.41346153846154,6.5,104,74
"879",74,3.49,3,206,313,0.0148235851290552,1.51941747572816,1.51941747572816,1.3907744490086,58,41,107,0.593386650085449,2.08080808080808,1.39189189189189,5.73648648648649,148,99
"880",74,6.38,4,245,412,0.0137838742054199,1.68163265306122,1.68163265306122,1.50802515614799,66,51,128,0.547268271446228,2.09401709401709,1.36871508379888,5.26815642458101,179,117
"881",74,7.08,5,258,453,0.0136639218170301,1.75581395348837,1.75581395348837,1.55004621630911,68,53,137,0.514926254749298,2.13223140495868,1.35789473684211,5.10526315789474,190,121
"882",74,7.86,6,271,487,0.0133114664479978,1.7970479704797,1.7970479704797,1.53476363996265,69,54,148,0.498180627822876,2.20325203252033,1.34158415841584,4.98019801980198,202,123
"883",74,11.44,7,303,581,0.012698620855463,1.91749174917492,1.91749174917492,1.62854982624965,77,65,161,0.446208238601685,2.13380281690141,1.34070796460177,4.65486725663717,226,142
"884",74,12.96,8,315,620,0.0125366494793246,1.96825396825397,1.96825396825397,1.66387084863734,81,68,166,0.465171724557877,2.11409395973154,1.34615384615385,4.55555555555556,234,149
"885",74,16.44,9,324,652,0.0124603447616864,2.01234567901235,2.01234567901235,1.68278544590494,82,71,171,0.456178903579712,2.11764705882353,1.33884297520661,4.4504132231405,242,153
"886",74,17.01,10,328,680,0.0126799433131946,2.07317073170732,2.07317073170732,1.7299688397458,83,73,172,0.430357962846756,2.1025641025641,1.33877551020408,4.41224489795918,245,156
"887",74,20.25,11,339,717,0.0125150547206367,2.11504424778761,2.11504424778761,1.7706587744849,85,76,178,0.435257375240326,2.1055900621118,1.33464566929134,4.30708661417323,254,161
"888",74,21.5,12,349,753,0.0123999604782136,2.15759312320917,2.15759312320917,1.78717874239867,88,78,183,0.424523204565048,2.10240963855422,1.33716475095785,4.24521072796935,261,166
"889",75,1.52,1,120,123,0.0172268907563025,1.025,1.025,1.07664941419089,38,25,57,0.737590074539185,1.9047619047619,1.46341463414634,7.03658536585366,82,63
"890",75,1.65,2,167,202,0.0145732631123296,1.20958083832335,1.20958083832335,1.22029294652676,49,32,86,0.63547694683075,2.06172839506173,1.41525423728814,6.07627118644068,118,81
"891",75,5.13,3,199,271,0.0137556469214761,1.36180904522613,1.36180904522613,1.38852085285072,57,41,101,0.573569297790527,2.03061224489796,1.40140845070423,5.8943661971831,142,98
"892",75,7.35,4,242,378,0.0129625184321525,1.56198347107438,1.56198347107438,1.47633954597785,66,51,125,0.53530490398407,2.06837606837607,1.375,5.30681818181818,176,117
"893",75,7.92,5,255,424,0.013092481086923,1.66274509803922,1.66274509803922,1.6530824269282,70,54,131,0.503718554973602,2.05645161290323,1.37837837837838,5.18918918918919,185,124
"894",75,11.16,6,274,475,0.012700195181947,1.73357664233577,1.73357664233577,1.72295625933739,74,59,141,0.512997210025787,2.06015037593985,1.37,4.93,200,133
"895",75,12.3,7,277,501,0.0131062627531,1.8086642599278,1.8086642599278,1.75752210901652,74,60,143,0.505999982357025,2.06716417910448,1.36453201970443,4.87684729064039,203,134
"896",75,15.88,8,305,591,0.0127480586712683,1.93770491803279,1.93770491803279,1.80718587548577,81,70,154,0.467049419879913,2.01986754966887,1.36160714285714,4.67857142857143,224,151
"897",75,16.66,9,314,624,0.0126981542907145,1.98726114649682,1.98726114649682,1.77806378217084,82,71,161,0.449199497699738,2.05228758169935,1.35344827586207,4.56896551724138,232,153
"898",75,17.91,10,329,669,0.0123989917710727,2.03343465045593,2.03343465045593,1.79927020495613,86,73,170,0.467462539672852,2.06918238993711,1.35390946502058,4.44855967078189,243,159
"899",75,18.61,11,337,699,0.0123463331920305,2.07418397626113,2.07418397626113,1.79914578954811,87,74,176,0.450145363807678,2.09316770186335,1.348,4.376,250,161
"900",75,21.5,12,349,753,0.0123999604782136,2.15759312320917,2.15759312320917,1.78717874239867,88,78,183,0.424523204565048,2.10240963855422,1.33716475095785,4.24521072796935,261,166
"901",76,0.78,1,137,147,0.0157793044224989,1.07299270072993,1.07299270072993,1.13376587282185,42,25,70,0.767758846282959,2.04477611940298,1.44210526315789,6.95789473684211,95,67
"902",76,4.36,2,213,299,0.0132429798919302,1.4037558685446,1.4037558685446,1.39527472945241,62,49,102,0.601150989532471,1.91891891891892,1.41059602649007,5.70198675496689,151,111
"903",76,5.5,3,230,354,0.0134421872033416,1.53913043478261,1.53913043478261,1.46553888974358,67,51,112,0.561384797096252,1.94915254237288,1.41104294478528,5.41104294478528,163,118
"904",76,6.07,4,246,402,0.0133399701343952,1.63414634146341,1.63414634146341,1.64157670353407,71,56,119,0.499102771282196,1.93700787401575,1.40571428571429,5.25142857142857,175,127
"905",76,6.77,5,261,446,0.0131447096964338,1.7088122605364,1.7088122605364,1.61731402569393,72,59,130,0.484098732471466,1.99236641221374,1.38095238095238,5.02645502645503,189,131
"906",76,8.99,6,289,519,0.0124711649365629,1.79584775086505,1.79584775086505,1.67275995221665,77,62,150,0.484216332435608,2.07913669064748,1.36320754716981,4.83490566037736,212,139
"907",76,12.47,7,299,559,0.0125474175663846,1.8695652173913,1.8695652173913,1.70443117900731,78,65,156,0.490269839763641,2.09090909090909,1.35294117647059,4.70135746606335,221,143
"908",76,12.6,8,303,585,0.0127860468166022,1.93069306930693,1.93069306930693,1.70004990441316,78,65,160,0.450263738632202,2.11888111888112,1.34666666666667,4.66222222222222,225,143
"909",76,13.85,9,317,625,0.0124785369165036,1.97160883280757,1.97160883280757,1.72631646071387,82,67,168,0.475553274154663,2.12751677852349,1.34893617021277,4.54468085106383,235,149
"910",76,15.37,10,327,660,0.012382506894805,2.01834862385321,2.01834862385321,1.75016749040946,85,71,171,0.442776650190353,2.09615384615385,1.35123966942149,4.47107438016529,242,156
"911",76,18.61,11,337,699,0.0123463331920305,2.07418397626113,2.07418397626113,1.79914578954811,87,74,176,0.450145363807678,2.09316770186335,1.348,4.376,250,161
"912",76,21.5,12,349,753,0.0123999604782136,2.15759312320917,2.15759312320917,1.78717874239867,88,78,183,0.424523204565048,2.10240963855422,1.33716475095785,4.24521072796935,261,166
"913",77,1.52,1,120,123,0.0172268907563025,1.025,1.025,1.07664941419089,38,25,57,0.737590074539185,1.9047619047619,1.46341463414634,7.03658536585366,82,63
"914",77,4.41,2,211,284,0.0128187767998195,1.34597156398104,1.34597156398104,1.36778047020215,63,45,103,0.598021268844604,1.9537037037037,1.42567567567568,5.79054054054054,148,108
"915",77,7.65,3,249,354,0.0114652157015157,1.42168674698795,1.42168674698795,1.49393432921394,72,54,123,0.585252523422241,1.97619047619048,1.40677966101695,5.19774011299435,177,126
"916",77,8.9,4,269,416,0.0115408089663208,1.54646840148699,1.54646840148699,1.55743719374375,76,58,135,0.547117710113525,2.00746268656716,1.39378238341969,5.03626943005181,193,134
"917",77,9.47,5,277,461,0.0120598545492597,1.66425992779783,1.66425992779783,1.70557114105106,78,63,136,0.529566526412964,1.9645390070922,1.39195979899497,4.94472361809045,199,141
"918",77,13.05,6,302,554,0.0121889507381576,1.83443708609272,1.83443708609272,1.74312533319809,84,71,147,0.495831102132797,1.94838709677419,1.38532110091743,4.6697247706422,218,155
"919",77,15.27,7,316,624,0.012537673297167,1.9746835443038,1.9746835443038,1.77634678130684,85,74,157,0.469818323850632,1.9874213836478,1.36796536796537,4.56277056277056,231,159
"920",77,16.05,8,325,655,0.0124406457739791,2.01538461538462,2.01538461538462,1.75966203163863,86,74,165,0.455440849065781,2.03125,1.35983263598326,4.47280334728034,239,160
"921",77,17.19,9,329,674,0.012491659871006,2.04863221884498,2.04863221884498,1.76517730943682,86,74,169,0.438535213470459,2.05625,1.35390946502058,4.4320987654321,243,160
"922",77,17.32,10,334,697,0.0125334915754077,2.08682634730539,2.08682634730539,1.76361202233854,86,74,174,0.431332051753998,2.0875,1.34677419354839,4.37903225806452,248,160
"923",77,20.8,11,343,727,0.0123949329105076,2.11953352769679,2.11953352769679,1.78112268408736,87,77,179,0.410857290029526,2.09146341463415,1.33984375,4.28515625,256,164
"924",77,21.5,12,349,753,0.0123999604782136,2.15759312320917,2.15759312320917,1.78717874239867,88,78,183,0.424523204565048,2.10240963855422,1.33716475095785,4.24521072796935,261,166
"925",78,0.13,1,110,118,0.0196830692243536,1.07272727272727,1.07272727272727,1.0390487353936,31,22,57,0.75061047077179,2.07547169811321,1.39240506329114,6.9873417721519,79,53
"926",78,3.02,2,192,266,0.0145069808027923,1.38541666666667,1.38541666666667,1.39114606637587,56,42,94,0.573385953903198,1.95918367346939,1.41176470588235,6.09558823529412,136,98
"927",78,3.72,3,217,329,0.0140382317801673,1.51612903225806,1.51612903225806,1.42498048683403,61,45,111,0.529397308826447,2.04716981132075,1.39102564102564,5.62820512820513,156,106
"928",78,4.29,4,238,390,0.0138283161365812,1.63865546218487,1.63865546218487,1.61940883817905,65,50,123,0.509171605110168,2.0695652173913,1.3757225433526,5.25433526011561,173,115
"929",78,7.77,5,254,433,0.013476082288133,1.70472440944882,1.70472440944882,1.62473310715094,67,53,134,0.504157602787018,2.11666666666667,1.35828877005348,5.05347593582888,187,120
"930",78,9.99,6,277,508,0.013289384188772,1.83393501805054,1.83393501805054,1.67691790857948,72,58,147,0.461065918207169,2.13076923076923,1.35121951219512,4.88780487804878,205,130
"931",78,11.51,7,291,545,0.0129162223012205,1.87285223367698,1.87285223367698,1.7047920494422,76,62,153,0.460469663143158,2.10869565217391,1.35348837209302,4.76279069767442,215,138
"932",78,12.76,8,305,588,0.0126833477135462,1.92786885245902,1.92786885245902,1.73276668020894,80,67,158,0.422870606184006,2.07482993197279,1.35555555555556,4.68444444444444,225,147
"933",78,16.34,9,328,669,0.0124748265831282,2.03963414634146,2.03963414634146,1.76389021453963,85,75,168,0.416809171438217,2.05,1.34979423868313,4.44444444444444,243,160
"934",78,19.58,10,339,709,0.012375416732122,2.09144542772861,2.09144542772861,1.79735880054936,87,78,174,0.443883895874023,2.05454545454545,1.3452380952381,4.34523809523809,252,165
"935",78,20.72,11,342,727,0.0124676304642349,2.12573099415205,2.12573099415205,1.80164285871487,87,78,177,0.454396992921829,2.07272727272727,1.34117647058824,4.30980392156863,255,165
"936",78,21.5,12,349,753,0.0123999604782136,2.15759312320917,2.15759312320917,1.78717874239867,88,78,183,0.424523204565048,2.10240963855422,1.33716475095785,4.24521072796935,261,166
"937",79,0.57,1,142,160,0.0159824193387274,1.12676056338028,1.12676056338028,1.50917260456006,45,31,66,0.703574180603027,1.86842105263158,1.4639175257732,6.31958762886598,97,76
"938",79,3.81,2,193,247,0.0133311744386874,1.27979274611399,1.27979274611399,1.60381693340188,59,41,93,0.624063611030579,1.93,1.44029850746269,5.76865671641791,134,100
"939",79,4.51,3,224,307,0.012291800128123,1.37053571428571,1.37053571428571,1.59096431117808,64,44,116,0.571889400482178,2.07407407407407,1.4,5.425,160,108
"940",79,5.29,4,242,356,0.0122080861424505,1.47107438016529,1.47107438016529,1.58867067246665,67,49,126,0.527001023292542,2.08620689655172,1.38285714285714,5.23428571428571,175,116
"941",79,8.18,5,270,444,0.0122263527467988,1.64444444444444,1.64444444444444,1.64308735518355,73,57,140,0.501859068870544,2.07692307692308,1.37055837563452,4.9238578680203,197,130
"942",79,8.31,6,274,475,0.012700195181947,1.73357664233577,1.73357664233577,1.64329871161221,73,58,143,0.500328063964844,2.09160305343511,1.36318407960199,4.87562189054726,201,131
"943",79,11.79,7,289,517,0.012423106497501,1.78892733564014,1.78892733564014,1.65422401763887,75,61,153,0.480068415403366,2.125,1.35046728971963,4.72429906542056,214,136
"944",79,13.31,8,303,551,0.0120429261469193,1.81848184818482,1.81848184818482,1.68486595057605,78,65,160,0.452995836734772,2.11888111888112,1.34666666666667,4.63111111111111,225,143
"945",79,14.45,9,306,575,0.0123218686381656,1.87908496732026,1.87908496732026,1.71093302996599,78,65,163,0.461001098155975,2.13986013986014,1.34210526315789,4.58771929824561,228,143
"946",79,18.03,10,327,657,0.0123262227725559,2.00917431192661,2.00917431192661,1.73621369174931,84,74,169,0.457758456468582,2.06962025316456,1.34567901234568,4.39094650205761,243,158
"947",79,19.28,11,338,695,0.0122030446157358,2.05621301775148,2.05621301775148,1.754077781403,87,76,175,0.441011279821396,2.07361963190184,1.34661354581673,4.31075697211155,251,163
"948",79,21.5,12,349,753,0.0123999604782136,2.15759312320917,2.15759312320917,1.78717874239867,88,78,183,0.424523204565048,2.10240963855422,1.33716475095785,4.24521072796935,261,166
"949",80,3.48,1,144,158,0.0153457653457653,1.09722222222222,1.09722222222222,1.24917081106252,45,30,69,0.688811957836151,1.92,1.45454545454545,6.97979797979798,99,75
"950",80,4.62,2,165,231,0.0170731707317073,1.4,1.4,1.35434334401559,51,35,79,0.623151659965515,1.91860465116279,1.44736842105263,6.39473684210526,114,86
"951",80,7.51,3,218,337,0.0142476641440832,1.54587155963303,1.54587155963303,1.43109157650793,62,46,110,0.56788831949234,2.01851851851852,1.3974358974359,5.56410256410256,156,108
"952",80,7.64,4,230,374,0.0142016328080501,1.62608695652174,1.62608695652174,1.4763852852302,63,47,120,0.545165002346039,2.09090909090909,1.37724550898204,5.35329341317365,167,110
"953",80,8.42,5,248,414,0.0135170432284184,1.66935483870968,1.66935483870968,1.46280889275403,65,50,133,0.553878128528595,2.15652173913043,1.3551912568306,5.12021857923497,183,115
"954",80,12,6,286,513,0.0125874125874126,1.79370629370629,1.79370629370629,1.56882872754328,75,63,148,0.515630662441254,2.07246376811594,1.35545023696682,4.74881516587678,211,138
"955",80,14.22,7,306,584,0.0125147326690239,1.90849673202614,1.90849673202614,1.63601807183543,78,67,161,0.469068199396133,2.11034482758621,1.34210526315789,4.60964912280702,228,145
"956",80,14.79,8,311,613,0.0127165231822425,1.97106109324759,1.97106109324759,1.7024634264958,79,69,163,0.433405935764313,2.10135135135135,1.34051724137931,4.56034482758621,232,148
"957",80,16.31,9,320,649,0.0127155172413793,2.028125,2.028125,1.72285829711766,82,72,166,0.439284324645996,2.07792207792208,1.34453781512605,4.48739495798319,238,154
"958",80,19.55,10,331,687,0.0125789618236748,2.07552870090634,2.07552870090634,1.76351855952467,84,75,172,0.410711258649826,2.08176100628931,1.34008097165992,4.37651821862348,247,159
"959",80,20.8,11,343,727,0.0123949329105076,2.11953352769679,2.11953352769679,1.78112268408736,87,77,179,0.410857290029526,2.09146341463415,1.33984375,4.28515625,256,164
"960",80,21.5,12,349,753,0.0123999604782136,2.15759312320917,2.15759312320917,1.78717874239867,88,78,183,0.424523204565048,2.10240963855422,1.33716475095785,4.24521072796935,261,166
"961",81,1.14,1,114,141,0.0218910107126223,1.23684210526316,1.23684210526316,1.17486110561291,37,25,52,0.668024718761444,1.83870967741935,1.48051948051948,7.28571428571429,77,62
"962",81,1.27,2,147,201,0.0187307799832262,1.36734693877551,1.36734693877551,1.24949020263686,43,31,73,0.598648548126221,1.98648648648649,1.41346153846154,6.5,104,74
"963",81,2.52,3,186,282,0.0163905841325196,1.51612903225806,1.51612903225806,1.41749556463119,54,41,91,0.575926780700684,1.95789473684211,1.40909090909091,6.00757575757576,132,95
"964",81,6.1,4,242,407,0.013956997359487,1.68181818181818,1.68181818181818,1.556038003989,70,53,119,0.52601283788681,1.96747967479675,1.40697674418605,5.23837209302326,172,123
"965",81,6.88,5,265,450,0.0128644939965695,1.69811320754717,1.69811320754717,1.54868764060272,73,55,137,0.512202441692352,2.0703125,1.38020833333333,4.97395833333333,192,128
"966",81,10.36,6,277,491,0.0128446607021399,1.77256317689531,1.77256317689531,1.5813959418783,75,59,143,0.521260499954224,2.06716417910448,1.37128712871287,4.81683168316832,202,134
"967",81,11.06,7,287,529,0.0128895494749153,1.84320557491289,1.84320557491289,1.59565193250154,76,61,150,0.482582986354828,2.0948905109489,1.36018957345972,4.70142180094787,211,137
"968",81,13.28,8,311,598,0.012405352141894,1.92282958199357,1.92282958199357,1.68447086147826,81,65,165,0.489261835813522,2.13013698630137,1.35217391304348,4.57826086956522,230,146
"969",81,16.52,9,323,640,0.0123069822894833,1.98142414860681,1.98142414860681,1.7455466850857,84,68,171,0.478856235742569,2.125,1.35146443514644,4.48117154811716,239,152
"970",81,18.04,10,333,672,0.0121567350483013,2.01801801801802,2.01801801801802,1.76541825637337,86,72,175,0.44233962893486,2.10759493670886,1.34817813765182,4.40485829959514,247,158
"971",81,18.61,11,337,699,0.0123463331920305,2.07418397626113,2.07418397626113,1.79914578954811,87,74,176,0.450145363807678,2.09316770186335,1.348,4.376,250,161
"972",81,21.5,12,349,753,0.0123999604782136,2.15759312320917,2.15759312320917,1.78717874239867,88,78,183,0.424523204565048,2.10240963855422,1.33716475095785,4.24521072796935,261,166
"973",82,0.78,1,137,147,0.0157793044224989,1.07299270072993,1.07299270072993,1.13376587282185,42,25,70,0.767758846282959,2.04477611940298,1.44210526315789,6.95789473684211,95,67
"974",82,4.26,2,185,233,0.013689776733255,1.25945945945946,1.25945945945946,1.28713994722152,55,37,93,0.683195471763611,2.01086956521739,1.42307692307692,6.02307692307692,130,92
"975",82,5.51,3,218,310,0.0131061598951507,1.42201834862385,1.42201834862385,1.44258620839887,65,43,110,0.584656596183777,2.01851851851852,1.42483660130719,5.52941176470588,153,108
"976",82,8.4,4,254,396,0.0123245463882232,1.55905511811024,1.55905511811024,1.47648885583871,70,53,131,0.580788969993591,2.0650406504065,1.3804347826087,5.15760869565217,184,123
"977",82,8.53,5,261,429,0.0126436781609195,1.64367816091954,1.64367816091954,1.48252078110202,70,54,137,0.542104780673981,2.10483870967742,1.36649214659686,5.04188481675393,191,124
"978",82,9.23,6,274,468,0.0125130344108446,1.70802919708029,1.70802919708029,1.50945060432466,72,56,146,0.482823848724365,2.140625,1.35643564356436,4.8960396039604,202,128
"979",82,10.37,7,282,500,0.0126195704298226,1.77304964539007,1.77304964539007,1.54310201976939,72,56,154,0.490202039480209,2.203125,1.34285714285714,4.76666666666667,210,128
"980",82,11.89,8,299,537,0.0120536014904267,1.79598662207358,1.79598662207358,1.58557623949179,76,60,163,0.469604909420013,2.19852941176471,1.34080717488789,4.67264573991031,223,136
"981",82,15.47,9,322,624,0.0120740697741917,1.93788819875776,1.93788819875776,1.66222683874866,82,70,170,0.449042826890945,2.11842105263158,1.34166666666667,4.44166666666667,240,152
"982",82,16.04,10,325,655,0.0124406457739791,2.01538461538462,2.01538461538462,1.70972517679519,83,72,170,0.459674805402756,2.09677419354839,1.34297520661157,4.41322314049587,242,155
"983",82,19.28,11,338,695,0.0122030446157358,2.05621301775148,2.05621301775148,1.754077781403,87,76,175,0.441011279821396,2.07361963190184,1.34661354581673,4.31075697211155,251,163
"984",82,21.5,12,349,753,0.0123999604782136,2.15759312320917,2.15759312320917,1.78717874239867,88,78,183,0.424523204565048,2.10240963855422,1.33716475095785,4.24521072796935,261,166
"985",83,1.14,1,114,141,0.0218910107126223,1.23684210526316,1.23684210526316,1.17486110561291,37,25,52,0.668024718761444,1.83870967741935,1.48051948051948,7.28571428571429,77,62
"986",83,4.62,2,165,231,0.0170731707317073,1.4,1.4,1.35434334401559,51,35,79,0.623151659965515,1.91860465116279,1.44736842105263,6.39473684210526,114,86
"987",83,7.86,3,209,303,0.01394000736106,1.44976076555024,1.44976076555024,1.56571662121308,62,46,101,0.60343211889267,1.93518518518519,1.42176870748299,5.62585034013605,147,108
"988",83,8.64,4,238,356,0.0126227706272382,1.49579831932773,1.49579831932773,1.57026495058666,67,50,121,0.602823972702026,2.03418803418803,1.39181286549708,5.25146198830409,171,117
"989",83,10.16,5,255,395,0.0121970047861664,1.54901960784314,1.54901960784314,1.59430414665344,71,57,127,0.567527592182159,1.9921875,1.38586956521739,5.08695652173913,184,128
"990",83,13.05,6,287,474,0.0115494261835725,1.65156794425087,1.65156794425087,1.58230096469818,76,62,149,0.540010929107666,2.07971014492754,1.36018957345972,4.77251184834123,211,138
"991",83,16.63,7,311,564,0.011700031117104,1.81350482315113,1.81350482315113,1.65993268126806,82,71,158,0.481210052967072,2.03267973856209,1.35807860262009,4.55458515283843,229,153
"992",83,18.85,8,323,634,0.0121916043305194,1.96284829721362,1.96284829721362,1.69910841682375,83,73,167,0.47462409734726,2.07051282051282,1.34583333333333,4.45833333333333,240,156
"993",83,19.42,9,327,663,0.0124387910170541,2.02752293577982,2.02752293577982,1.76202211476843,84,75,168,0.422777831554413,2.05660377358491,1.34567901234568,4.41975308641975,243,159
"994",83,20.12,10,336,693,0.0123134328358209,2.0625,2.0625,1.76942929643608,85,76,175,0.447752118110657,2.08695652173913,1.33864541832669,4.33864541832669,251,161
"995",83,21.37,11,346,731,0.0122476334087292,2.11271676300578,2.11271676300578,1.78827717377754,88,78,180,0.458441913127899,2.08433734939759,1.34108527131783,4.27519379844961,258,166
"996",83,21.5,12,349,753,0.0123999604782136,2.15759312320917,2.15759312320917,1.78717874239867,88,78,183,0.424523204565048,2.10240963855422,1.33716475095785,4.24521072796935,261,166
"997",84,3.48,1,144,158,0.0153457653457653,1.09722222222222,1.09722222222222,1.24917081106252,45,30,69,0.688811957836151,1.92,1.45454545454545,6.97979797979798,99,75
"998",84,4.26,2,185,233,0.013689776733255,1.25945945945946,1.25945945945946,1.28713994722152,55,37,93,0.683195471763611,2.01086956521739,1.42307692307692,6.02307692307692,130,92
"999",84,6.48,3,233,344,0.0127275418084949,1.47639484978541,1.47639484978541,1.42724139009746,64,47,122,0.603400528430939,2.0990990990991,1.37869822485207,5.46745562130178,169,111
"1000",84,7.18,4,252,392,0.0123948649845064,1.55555555555556,1.55555555555556,1.45637429930732,69,49,134,0.55366575717926,2.13559322033898,1.37704918032787,5.2568306010929,183,118
"1001",84,8.7,5,270,433,0.01192344761118,1.6037037037037,1.6037037037037,1.49032030588674,73,54,143,0.524497449398041,2.1259842519685,1.37055837563452,5.05583756345178,197,127
"1002",84,9.95,6,289,488,0.0117262591311034,1.68858131487889,1.68858131487889,1.59838595101942,79,60,150,0.511035323143005,2.07913669064748,1.37619047619048,4.87619047619048,210,139
"1003",84,12.84,7,308,556,0.0117602267439401,1.80519480519481,1.80519480519481,1.61406088510717,80,65,163,0.477922320365906,2.12413793103448,1.35087719298246,4.66228070175439,228,145
"1004",84,16.42,8,330,644,0.0118633139909736,1.95151515151515,1.95151515151515,1.71312944933097,85,73,172,0.419476449489594,2.08860759493671,1.3469387755102,4.43673469387755,245,158
"1005",84,19.66,9,340,684,0.0118688183237897,2.01176470588235,2.01176470588235,1.7479586936763,87,76,177,0.447612106800079,2.08588957055215,1.34387351778656,4.33596837944664,253,163
"1006",84,20.8,10,343,705,0.0120198455321978,2.05539358600583,2.05539358600583,1.75496877888098,87,76,180,0.461600542068481,2.10429447852761,1.33984375,4.30078125,256,163
"1007",84,20.93,11,346,727,0.0121806148948647,2.10115606936416,2.10115606936416,1.75428805533464,87,76,183,0.430474996566772,2.12269938650307,1.33590733590734,4.27027027027027,259,163
"1008",84,21.5,12,349,753,0.0123999604782136,2.15759312320917,2.15759312320917,1.78717874239867,88,78,183,0.424523204565048,2.10240963855422,1.33716475095785,4.24521072796935,261,166
"1009",85,1.14,1,114,141,0.0218910107126223,1.23684210526316,1.23684210526316,1.17486110561291,37,25,52,0.668024718761444,1.83870967741935,1.48051948051948,7.28571428571429,77,62
"1010",85,2.66,2,164,215,0.0160855903037558,1.3109756097561,1.3109756097561,1.27742765444348,53,36,75,0.604618668556213,1.84269662921348,1.47747747747748,6.18918918918919,111,89
"1011",85,6.24,3,220,341,0.0141552511415525,1.55,1.55,1.49658650496074,69,53,98,0.536106467247009,1.80327868852459,1.45695364238411,5.59602649006623,151,122
"1012",85,6.37,4,238,386,0.0136864872531291,1.6218487394958,1.6218487394958,1.53661272631405,72,54,112,0.528541088104248,1.88888888888889,1.43373493975904,5.30120481927711,166,126
"1013",85,7.15,5,260,435,0.0129195129195129,1.67307692307692,1.67307692307692,1.52371435390236,74,58,128,0.509945869445801,1.96969696969697,1.39784946236559,5.05913978494624,186,132
"1014",85,10.04,6,287,515,0.0125484271825735,1.79442508710801,1.79442508710801,1.57377274738038,77,64,146,0.488042235374451,2.0354609929078,1.36666666666667,4.77619047619048,210,141
"1015",85,10.61,7,293,551,0.0128804525690776,1.88054607508532,1.88054607508532,1.65978533974522,78,66,149,0.46282622218132,2.03472222222222,1.36279069767442,4.71162790697674,215,144
"1016",85,13.85,8,308,593,0.0125428317610728,1.92532467532468,1.92532467532468,1.70887565820569,82,70,156,0.478842556476593,2.02631578947368,1.36283185840708,4.56194690265487,226,152
"1017",85,16.07,9,321,655,0.0127531152647975,2.0404984423676,2.0404984423676,1.74443976285857,83,72,166,0.460255235433578,2.07096774193548,1.34873949579832,4.47058823529412,238,155
"1018",85,17.32,10,334,697,0.0125334915754077,2.08682634730539,2.08682634730539,1.76361202233854,86,74,174,0.431332051753998,2.0875,1.34677419354839,4.37903225806452,248,160
"1019",85,20.8,11,343,727,0.0123949329105076,2.11953352769679,2.11953352769679,1.78112268408736,87,77,179,0.410857290029526,2.09146341463415,1.33984375,4.28515625,256,164
"1020",85,21.5,12,349,753,0.0123999604782136,2.15759312320917,2.15759312320917,1.78717874239867,88,78,183,0.424523204565048,2.10240963855422,1.33716475095785,4.24521072796935,261,166
"1021",86,0.57,1,142,160,0.0159824193387274,1.12676056338028,1.12676056338028,1.50917260456006,45,31,66,0.703574180603027,1.86842105263158,1.4639175257732,6.31958762886598,97,76
"1022",86,1.82,2,186,257,0.0149375181633246,1.38172043010753,1.38172043010753,1.63822943796197,57,43,86,0.56091696023941,1.86,1.44186046511628,5.9922480620155,129,100
"1023",86,4.71,3,233,361,0.01335651916531,1.54935622317597,1.54935622317597,1.64535516829674,67,51,115,0.542276382446289,1.97457627118644,1.40361445783133,5.45180722891566,166,118
"1024",86,5.41,4,246,405,0.0134395221503235,1.64634146341463,1.64634146341463,1.62717811894624,68,54,124,0.50099378824234,2.01639344262295,1.38202247191011,5.25842696629214,178,122
"1025",86,8.99,5,282,504,0.0127205269932611,1.78723404255319,1.78723404255319,1.66999872697484,77,65,140,0.515800178050995,1.98591549295775,1.37560975609756,4.83414634146341,205,142
"1026",86,11.21,6,304,576,0.0125065138092757,1.89473684210526,1.89473684210526,1.73186407551469,81,69,154,0.507259428501129,2.02666666666667,1.36322869955157,4.68609865470852,223,150
"1027",86,11.99,7,313,606,0.0124109117719341,1.93610223642173,1.93610223642173,1.71471897107089,82,69,162,0.4533351957798,2.07284768211921,1.35497835497835,4.59307359307359,231,151
"1028",86,15.47,8,324,640,0.012231013263005,1.97530864197531,1.97530864197531,1.72583583700777,83,72,169,0.479597151279449,2.09032258064516,1.34439834024896,4.47717842323651,241,155
"1029",86,18.71,9,335,682,0.0121905442845652,2.03582089552239,2.03582089552239,1.76524760743898,86,75,174,0.477518886327744,2.08074534161491,1.34538152610442,4.37349397590361,249,161
"1030",86,18.84,10,338,704,0.0123610696539252,2.08284023668639,2.08284023668639,1.76292153152848,86,75,177,0.457429736852646,2.09937888198758,1.34126984126984,4.34126984126984,252,161
"1031",86,19.98,11,341,722,0.0124547179575643,2.11730205278592,2.11730205278592,1.7696502766845,86,75,180,0.456926554441452,2.11801242236025,1.33725490196078,4.30588235294118,255,161
"1032",86,21.5,12,349,753,0.0123999604782136,2.15759312320917,2.15759312320917,1.78717874239867,88,78,183,0.424523204565048,2.10240963855422,1.33716475095785,4.24521072796935,261,166
"1033",87,0.13,1,110,118,0.0196830692243536,1.07272727272727,1.07272727272727,1.0390487353936,31,22,57,0.75061047077179,2.07547169811321,1.39240506329114,6.9873417721519,79,53
"1034",87,2.35,2,195,268,0.0141686492201956,1.37435897435897,1.37435897435897,1.32740931226583,56,40,99,0.623092532157898,2.03125,1.40287769784173,5.97841726618705,139,96
"1035",87,3.87,3,222,326,0.0132893074069545,1.46846846846847,1.46846846846847,1.40539526758753,62,47,113,0.596042335033417,2.03669724770642,1.3875,5.50625,160,109
"1036",87,4.44,4,236,375,0.0135232600072124,1.58898305084746,1.58898305084746,1.6011431566346,66,50,120,0.556863963603973,2.03448275862069,1.38823529411765,5.38823529411765,170,116
"1037",87,5.69,5,263,442,0.0128290714886947,1.68060836501901,1.68060836501901,1.70736010950825,74,58,131,0.504796147346497,1.99242424242424,1.39153439153439,5.15873015873016,189,132
"1038",87,6.39,6,273,481,0.0129551820728291,1.76190476190476,1.76190476190476,1.70392775220345,76,59,138,0.490583956241608,2.02222222222222,1.38578680203046,5.06598984771574,197,135
"1039",87,7.53,7,278,507,0.0131678051060956,1.82374100719424,1.82374100719424,1.7101138723199,76,60,142,0.465897500514984,2.04411764705882,1.37623762376238,4.98514851485149,202,136
"1040",87,10.77,8,293,550,0.0128570760671373,1.87713310580205,1.87713310580205,1.76893917198442,78,64,151,0.466216504573822,2.06338028169014,1.36279069767442,4.81860465116279,215,142
"1041",87,13.66,9,310,616,0.012861467794133,1.98709677419355,1.98709677419355,1.76245643099964,80,68,162,0.447632908821106,2.09459459459459,1.34782608695652,4.62608695652174,230,148
"1042",87,17.14,10,321,648,0.0126168224299065,2.01869158878505,2.01869158878505,1.77874522317641,82,71,168,0.431686788797379,2.09803921568627,1.34309623430962,4.5020920502092,239,153
"1043",87,17.92,11,329,675,0.0125101934909927,2.0516717325228,2.0516717325228,1.76028004046815,83,71,175,0.41419917345047,2.13636363636364,1.33739837398374,4.41869918699187,246,154
"1044",87,21.5,12,349,753,0.0123999604782136,2.15759312320917,2.15759312320917,1.78717874239867,88,78,183,0.424523204565048,2.10240963855422,1.33716475095785,4.24521072796935,261,166
"1045",88,0.57,1,142,160,0.0159824193387274,1.12676056338028,1.12676056338028,1.50917260456006,45,31,66,0.703574180603027,1.86842105263158,1.4639175257732,6.31958762886598,97,76
"1046",88,3.81,2,193,247,0.0133311744386874,1.27979274611399,1.27979274611399,1.60381693340188,59,41,93,0.624063611030579,1.93,1.44029850746269,5.76865671641791,134,100
"1047",88,5.33,3,218,298,0.012598824673403,1.36697247706422,1.36697247706422,1.61426317158759,66,49,103,0.604567468166351,1.89565217391304,1.43421052631579,5.49342105263158,152,115
"1048",88,7.55,4,247,393,0.0129357164016984,1.59109311740891,1.59109311740891,1.66463702426527,70,55,122,0.527426600456238,1.976,1.3954802259887,5.22033898305085,177,125
"1049",88,8.69,5,251,426,0.0135776892430279,1.69721115537849,1.69721115537849,1.68926882825253,70,56,125,0.535467505455017,1.99206349206349,1.38674033149171,5.14917127071823,181,126
"1050",88,9.94,6,275,487,0.0129263437292634,1.77090909090909,1.77090909090909,1.77540837626606,76,63,136,0.524128377437592,1.97841726618705,1.38190954773869,4.98994974874372,199,139
"1051",88,12.83,7,296,560,0.0128263857077416,1.89189189189189,1.89189189189189,1.75132741078242,79,67,150,0.485868960618973,2.02739726027397,1.36405529953917,4.76036866359447,217,146
"1052",88,13.61,8,307,591,0.0125822315897043,1.92508143322476,1.92508143322476,1.73388910450835,80,67,160,0.476358532905579,2.08843537414966,1.35242290748899,4.64757709251101,227,147
"1053",88,17.19,9,329,674,0.012491659871006,2.04863221884498,2.04863221884498,1.76517730943682,86,74,169,0.438535213470459,2.05625,1.35390946502058,4.4320987654321,243,160
"1054",88,20.67,10,339,705,0.0123055977378646,2.07964601769911,2.07964601769911,1.78176726667352,87,77,175,0.462940514087677,2.06707317073171,1.3452380952381,4.32539682539683,252,164
"1055",88,20.8,11,343,727,0.0123949329105076,2.11953352769679,2.11953352769679,1.78112268408736,87,77,179,0.410857290029526,2.09146341463415,1.33984375,4.28515625,256,164
"1056",88,21.5,12,349,753,0.0123999604782136,2.15759312320917,2.15759312320917,1.78717874239867,88,78,183,0.424523204565048,2.10240963855422,1.33716475095785,4.24521072796935,261,166
"1057",89,0.78,1,137,147,0.0157793044224989,1.07299270072993,1.07299270072993,1.13376587282185,42,25,70,0.767758846282959,2.04477611940298,1.44210526315789,6.95789473684211,95,67
"1058",89,1.48,2,185,226,0.0132784958871915,1.22162162162162,1.22162162162162,1.18549402928064,51,36,98,0.636277377605438,2.1264367816092,1.38059701492537,6.09701492537313,134,87
"1059",89,4.72,3,225,301,0.0119444444444444,1.33777777777778,1.33777777777778,1.40586868969983,61,47,117,0.624568164348602,2.08333333333333,1.3719512195122,5.4390243902439,164,108
"1060",89,8.2,4,251,362,0.0115378486055777,1.44223107569721,1.44223107569721,1.49993282512914,70,50,131,0.579313099384308,2.09166666666667,1.38674033149171,5.17127071823204,181,120
"1061",89,8.33,5,257,399,0.0121291342412451,1.55252918287938,1.55252918287938,1.50279623368084,70,51,136,0.561884045600891,2.12396694214876,1.37433155080214,5.07486631016043,187,121
"1062",89,9.47,6,262,432,0.0126349039220848,1.64885496183206,1.64885496183206,1.57387054293963,70,53,139,0.521422743797302,2.13008130081301,1.36458333333333,4.98958333333333,192,123
"1063",89,10.04,7,269,470,0.0130388947456028,1.74721189591078,1.74721189591078,1.68715153671257,71,55,143,0.477827101945877,2.13492063492063,1.35858585858586,4.91414141414141,198,126
"1064",89,12.26,8,289,537,0.01290369088812,1.85813148788927,1.85813148788927,1.72101035937284,74,58,157,0.47338131070137,2.18939393939394,1.34418604651163,4.7906976744186,215,132
"1065",89,13.51,9,302,581,0.0127829970737718,1.92384105960265,1.92384105960265,1.7539626881117,79,62,161,0.455048143863678,2.14184397163121,1.3542600896861,4.68609865470852,223,141
"1066",89,15.03,10,315,616,0.0124557678697806,1.95555555555556,1.95555555555556,1.77783938411692,82,67,166,0.439757138490677,2.11409395973154,1.3519313304721,4.57510729613734,233,149
"1067",89,18.61,11,337,699,0.0123463331920305,2.07418397626113,2.07418397626113,1.79914578954811,87,74,176,0.450145363807678,2.09316770186335,1.348,4.376,250,161
"1068",89,21.5,12,349,753,0.0123999604782136,2.15759312320917,2.15759312320917,1.78717874239867,88,78,183,0.424523204565048,2.10240963855422,1.33716475095785,4.24521072796935,261,166
"1069",90,1.52,1,120,123,0.0172268907563025,1.025,1.025,1.07664941419089,38,25,57,0.737590074539185,1.9047619047619,1.46341463414634,7.03658536585366,82,63
"1070",90,5.1,2,202,274,0.0134968720752672,1.35643564356436,1.35643564356436,1.40143110452167,61,46,95,0.605533063411713,1.88785046728972,1.43262411347518,5.87943262411348,141,107
"1071",90,7.32,3,255,401,0.0123822757449436,1.57254901960784,1.57254901960784,1.58521642890439,75,59,121,0.542229175567627,1.90298507462687,1.41666666666667,5.22222222222222,180,134
"1072",90,8.02,4,273,447,0.0120394311570782,1.63736263736264,1.63736263736264,1.61887103716769,77,60,136,0.519280910491943,1.99270072992701,1.39285714285714,5.05102040816327,196,137
"1073",90,11.5,5,285,491,0.0121324437855201,1.72280701754386,1.72280701754386,1.65295397398045,79,64,142,0.506813049316406,1.99300699300699,1.38349514563107,4.88834951456311,206,143
"1074",90,11.63,6,291,526,0.0124659319824624,1.80756013745704,1.80756013745704,1.66516297215343,79,64,148,0.490656942129135,2.03496503496504,1.37264150943396,4.81132075471698,212,143
"1075",90,12.88,7,307,575,0.0122415958783079,1.87296416938111,1.87296416938111,1.72334441111647,83,68,156,0.478354632854462,2.03311258278146,1.37053571428571,4.65178571428571,224,151
"1076",90,14.02,8,311,601,0.0124675863499637,1.93247588424437,1.93247588424437,1.72768941016925,83,69,159,0.481580913066864,2.04605263157895,1.3640350877193,4.59210526315789,228,152
"1077",90,14.8,9,322,633,0.0122482150113194,1.96583850931677,1.96583850931677,1.7112359003121,84,69,169,0.45213371515274,2.10457516339869,1.35294117647059,4.49579831932773,238,153
"1078",90,15.37,10,327,660,0.012382506894805,2.01834862385321,2.01834862385321,1.75016749040946,85,71,171,0.442776650190353,2.09615384615385,1.35123966942149,4.47107438016529,242,156
"1079",90,18.26,11,340,716,0.012424084678119,2.10588235294118,2.10588235294118,1.75191769590306,86,75,179,0.429503411054611,2.11180124223602,1.33858267716535,4.32677165354331,254,161
"1080",90,21.5,12,349,753,0.0123999604782136,2.15759312320917,2.15759312320917,1.78717874239867,88,78,183,0.424523204565048,2.10240963855422,1.33716475095785,4.24521072796935,261,166
"1081",91,0.78,1,137,147,0.0157793044224989,1.07299270072993,1.07299270072993,1.13376587282185,42,25,70,0.767758846282959,2.04477611940298,1.44210526315789,6.95789473684211,95,67
"1082",91,0.91,2,167,203,0.0146454079792223,1.21556886227545,1.21556886227545,1.13905172275589,47,32,88,0.677703976631165,2.11392405063291,1.39166666666667,6.20833333333333,120,79
"1083",91,1.48,3,199,279,0.0141617176793056,1.40201005025126,1.40201005025126,1.46020304603107,55,41,103,0.569693386554718,2.07291666666667,1.38194444444444,5.77777777777778,144,96
"1084",91,4.96,4,220,334,0.0138646741386467,1.51818181818182,1.51818181818182,1.52436756305367,59,45,116,0.548840880393982,2.11538461538462,1.36645962732919,5.48447204968944,161,104
"1085",91,7.18,5,252,420,0.0132802124833997,1.66666666666667,1.66666666666667,1.60318408275134,67,51,134,0.541354894638062,2.13559322033898,1.36216216216216,5.21621621621622,185,118
"1086",91,10.76,6,288,520,0.0125822686798297,1.80555555555556,1.80555555555556,1.67502788310242,77,63,148,0.481789946556091,2.05714285714286,1.36492890995261,4.85781990521327,211,140
"1087",91,12.28,7,298,557,0.0125867172847039,1.86912751677852,1.86912751677852,1.69466318886515,80,67,151,0.485713064670563,2.02721088435374,1.36697247706422,4.76605504587156,218,147
"1088",91,13.42,8,302,583,0.0128270005060395,1.93046357615894,1.93046357615894,1.72440073664944,80,68,154,0.437610536813736,2.04054054054054,1.36036036036036,4.7027027027027,222,148
"1089",91,14.67,9,319,628,0.0123814593560853,1.96865203761755,1.96865203761755,1.75216521097554,84,70,165,0.448887377977371,2.07142857142857,1.35744680851064,4.54893617021277,235,154
"1090",91,17.56,10,334,689,0.0123896351441262,2.06287425149701,2.06287425149701,1.74554213299748,85,74,175,0.421163141727448,2.10062893081761,1.34136546184739,4.36947791164659,249,159
"1091",91,20.8,11,343,727,0.0123949329105076,2.11953352769679,2.11953352769679,1.78112268408736,87,77,179,0.410857290029526,2.09146341463415,1.33984375,4.28515625,256,164
"1092",91,21.5,12,349,753,0.0123999604782136,2.15759312320917,2.15759312320917,1.78717874239867,88,78,183,0.424523204565048,2.10240963855422,1.33716475095785,4.24521072796935,261,166
"1093",92,1.52,1,120,123,0.0172268907563025,1.025,1.025,1.07664941419089,38,25,57,0.737590074539185,1.9047619047619,1.46341463414634,7.03658536585366,82,63
"1094",92,2.22,2,193,223,0.0120358376511226,1.15544041450777,1.15544041450777,1.26060390648279,58,34,101,0.645619213581085,2.09782608695652,1.42962962962963,5.98518518518518,135,92
"1095",92,2.79,3,214,290,0.0127243210039051,1.35514018691589,1.35514018691589,1.54939065096667,62,44,108,0.558489799499512,2.0188679245283,1.40789473684211,5.72368421052632,152,106
"1096",92,2.92,4,225,337,0.0133730158730159,1.49777777777778,1.49777777777778,1.57355612896241,63,44,118,0.522167146205902,2.10280373831776,1.38888888888889,5.53086419753086,162,107
"1097",92,3.7,5,241,379,0.0131051175656985,1.57261410788382,1.57261410788382,1.53414775869899,64,49,128,0.502541065216064,2.13274336283186,1.36158192090395,5.31073446327684,177,113
"1098",92,7.18,6,259,425,0.0127203615575709,1.64092664092664,1.64092664092664,1.57331426138626,68,52,139,0.481591731309891,2.15833333333333,1.35602094240838,5.10994764397906,191,120
"1099",92,9.4,7,283,503,0.0126055685036213,1.7773851590106,1.7773851590106,1.6334514378862,74,57,152,0.506171703338623,2.16030534351145,1.35406698564593,4.91387559808612,209,131
"1100",92,12.29,8,301,575,0.0127353266888151,1.91029900332226,1.91029900332226,1.68236120563123,77,63,161,0.433547079563141,2.15,1.34375,4.69642857142857,224,140
"1101",92,15.53,9,315,617,0.0124759882721666,1.95873015873016,1.95873015873016,1.73309617331525,79,68,168,0.413810253143311,2.14285714285714,1.33474576271186,4.52966101694915,236,147
"1102",92,16.78,10,326,656,0.0123831996224634,2.01226993865031,2.01226993865031,1.75210498291026,83,71,172,0.451182335615158,2.11688311688312,1.34156378600823,4.45679012345679,243,154
"1103",92,17.92,11,329,675,0.0125101934909927,2.0516717325228,2.0516717325228,1.76028004046815,83,71,175,0.41419917345047,2.13636363636364,1.33739837398374,4.41869918699187,246,154
"1104",92,21.5,12,349,753,0.0123999604782136,2.15759312320917,2.15759312320917,1.78717874239867,88,78,183,0.424523204565048,2.10240963855422,1.33716475095785,4.24521072796935,261,166
"1105",93,3.58,1,171,218,0.0149982800137599,1.27485380116959,1.27485380116959,1.32365427157769,51,39,81,0.601738095283508,1.9,1.425,6.25833333333333,120,90
"1106",93,4.72,2,198,293,0.0150233297441419,1.47979797979798,1.47979797979798,1.427783722339,61,46,91,0.538765668869019,1.85046728971963,1.44525547445255,5.91970802919708,137,107
"1107",93,8.2,3,228,356,0.0137568591081227,1.56140350877193,1.56140350877193,1.55613425290591,68,52,108,0.550364553928375,1.9,1.425,5.54375,160,120
"1108",93,11.09,4,263,443,0.0128580965373117,1.68441064638783,1.68441064638783,1.56248727760983,73,60,130,0.532132625579834,1.97744360902256,1.38421052631579,5.04210526315789,190,133
"1109",93,12.61,5,275,479,0.01271400132714,1.74181818181818,1.74181818181818,1.59115984601667,76,64,135,0.493913441896439,1.96428571428571,1.38190954773869,4.93467336683417,199,140
"1110",93,13.39,6,293,521,0.0121791575108701,1.77815699658703,1.77815699658703,1.60238104198189,78,67,148,0.505638360977173,2.02068965517241,1.36279069767442,4.73023255813953,215,145
"1111",93,14.09,7,304,557,0.0120939725551503,1.83223684210526,1.83223684210526,1.62209453480175,79,68,157,0.481737285852432,2.06802721088435,1.35111111111111,4.61333333333333,225,147
"1112",93,14.66,8,308,590,0.0124793773002242,1.91558441558442,1.91558441558442,1.68693396035661,80,70,158,0.465004354715347,2.05333333333333,1.35087719298246,4.57017543859649,228,150
"1113",93,17.9,9,324,630,0.0120399036807706,1.94444444444444,1.94444444444444,1.74179606768891,84,74,166,0.480745762586594,2.05063291139241,1.35,4.425,240,158
"1114",93,18.03,10,327,657,0.0123262227725559,2.00917431192661,2.00917431192661,1.73621369174931,84,74,169,0.457758456468582,2.06962025316456,1.34567901234568,4.39094650205761,243,158
"1115",93,19.28,11,338,695,0.0122030446157358,2.05621301775148,2.05621301775148,1.754077781403,87,76,175,0.441011279821396,2.07361963190184,1.34661354581673,4.31075697211155,251,163
"1116",93,21.5,12,349,753,0.0123999604782136,2.15759312320917,2.15759312320917,1.78717874239867,88,78,183,0.424523204565048,2.10240963855422,1.33716475095785,4.24521072796935,261,166
"1117",94,1.14,1,114,141,0.0218910107126223,1.23684210526316,1.23684210526316,1.17486110561291,37,25,52,0.668024718761444,1.83870967741935,1.48051948051948,7.28571428571429,77,62
"1118",94,1.27,2,147,201,0.0187307799832262,1.36734693877551,1.36734693877551,1.24949020263686,43,31,73,0.598648548126221,1.98648648648649,1.41346153846154,6.5,104,74
"1119",94,2.05,3,186,265,0.015402499273467,1.4247311827957,1.4247311827957,1.28227383353804,52,36,98,0.603282332420349,2.11363636363636,1.38805970149254,5.75373134328358,134,88
"1120",94,4.27,4,225,361,0.0143253968253968,1.60444444444444,1.60444444444444,1.40099085079765,60,44,121,0.570303320884705,2.16346153846154,1.36363636363636,5.44242424242424,165,104
"1121",94,5.79,5,245,409,0.013683506189361,1.66938775510204,1.66938775510204,1.46439908614574,65,51,129,0.530212640762329,2.11206896551724,1.36111111111111,5.20555555555556,180,116
"1122",94,7.04,6,272,469,0.0127252007814196,1.72426470588235,1.72426470588235,1.55743251657542,74,57,141,0.491159826517105,2.0763358778626,1.37373737373737,4.97979797979798,198,131
"1123",94,7.74,7,282,506,0.0127710052749804,1.79432624113475,1.79432624113475,1.58543132238993,76,58,148,0.476335346698761,2.1044776119403,1.36893203883495,4.89805825242718,206,134
"1124",94,11.32,8,313,599,0.0122675514049316,1.91373801916933,1.91373801916933,1.67729124230681,83,66,164,0.466106534004211,2.1006711409396,1.36086956521739,4.60434782608696,230,149
"1125",94,11.89,9,318,627,0.0124397357300161,1.97169811320755,1.97169811320755,1.71974295623508,84,68,166,0.45640105009079,2.09210526315789,1.35897435897436,4.57692307692308,234,152
"1126",94,15.37,10,327,660,0.012382506894805,2.01834862385321,2.01834862385321,1.75016749040946,85,71,171,0.442776650190353,2.09615384615385,1.35123966942149,4.47107438016529,242,156
"1127",94,18.26,11,340,716,0.012424084678119,2.10588235294118,2.10588235294118,1.75191769590306,86,75,179,0.429503411054611,2.11180124223602,1.33858267716535,4.32677165354331,254,161
"1128",94,21.5,12,349,753,0.0123999604782136,2.15759312320917,2.15759312320917,1.78717874239867,88,78,183,0.424523204565048,2.10240963855422,1.33716475095785,4.24521072796935,261,166
"1129",95,0.7,1,144,151,0.0146658896658897,1.04861111111111,1.04861111111111,1.16294760117179,43,26,75,0.720012247562408,2.08695652173913,1.42574257425743,6.81188118811881,101,69
"1130",95,3.94,2,199,243,0.0123343992690726,1.22110552763819,1.22110552763819,1.4139695675428,57,40,102,0.622669339179993,2.05154639175258,1.40140845070423,5.75352112676056,142,97
"1131",95,7.52,3,249,363,0.0117567042363,1.4578313253012,1.4578313253012,1.57159348963599,72,53,124,0.554250240325928,1.992,1.40677966101695,5.25988700564972,177,125
"1132",95,7.65,4,259,407,0.0121816168327796,1.57142857142857,1.57142857142857,1.56751653218477,74,54,131,0.519163966178894,2.0234375,1.4,5.14054054054054,185,128
"1133",95,10.54,5,283,490,0.0122797784627722,1.73144876325088,1.73144876325088,1.60713130327345,78,63,142,0.483552694320679,2.00709219858156,1.38048780487805,4.84390243902439,205,141
"1134",95,11.32,6,295,528,0.012175717744725,1.78983050847458,1.78983050847458,1.58395735718725,79,66,150,0.488864123821259,2.03448275862069,1.36574074074074,4.69907407407407,216,145
"1135",95,12.46,7,301,556,0.0123145071982281,1.84717607973422,1.84717607973422,1.6171594272946,79,66,156,0.474215269088745,2.07586206896552,1.35585585585586,4.63063063063063,222,145
"1136",95,15.94,8,313,594,0.0121651511427869,1.89776357827476,1.89776357827476,1.65149245693456,81,69,163,0.461830735206604,2.08666666666667,1.34913793103448,4.50862068965517,232,150
"1137",95,18.16,9,326,658,0.012420953279849,2.01840490797546,2.01840490797546,1.70696620146864,82,71,173,0.459771513938904,2.13071895424837,1.33606557377049,4.41393442622951,244,153
"1138",95,19.68,10,335,689,0.0123156671731165,2.05671641791045,2.05671641791045,1.72496265247659,84,74,177,0.447749316692352,2.12025316455696,1.33466135458167,4.34262948207171,251,158
"1139",95,20.93,11,346,727,0.0121806148948647,2.10115606936416,2.10115606936416,1.75428805533464,87,76,183,0.430474996566772,2.12269938650307,1.33590733590734,4.27027027027027,259,163
"1140",95,21.5,12,349,753,0.0123999604782136,2.15759312320917,2.15759312320917,1.78717874239867,88,78,183,0.424523204565048,2.10240963855422,1.33716475095785,4.24521072796935,261,166
"1141",96,1.25,1,132,163,0.018852648623641,1.23484848484848,1.23484848484848,1.33070044194863,42,28,62,0.615510582923889,1.88571428571429,1.46666666666667,7.02222222222222,90,70
"1142",96,2.77,2,188,245,0.013937876891569,1.3031914893617,1.3031914893617,1.37875802917873,60,41,87,0.568646371364594,1.86138613861386,1.46875,6.078125,128,101
"1143",96,3.55,3,222,308,0.0125555419673067,1.38738738738739,1.38738738738739,1.44537310406657,67,47,108,0.583756685256958,1.94736842105263,1.43225806451613,5.55483870967742,155,114
"1144",96,5.77,4,260,409,0.0121473121473121,1.57307692307692,1.57307692307692,1.53269812144646,74,56,130,0.547312617301941,2,1.39784946236559,5.19354838709677,186,130
"1145",96,6.47,5,273,448,0.0120663650075415,1.64102564102564,1.64102564102564,1.55923026448726,76,57,140,0.511155664920807,2.05263157894737,1.38578680203046,5.04568527918782,197,133
"1146",96,9.71,6,289,495,0.0118944636678201,1.71280276816609,1.71280276816609,1.64529933870842,78,61,150,0.526733994483948,2.07913669064748,1.3696682464455,4.85781990521327,211,139
"1147",96,13.19,7,303,533,0.0116495093217931,1.75907590759076,1.75907590759076,1.6825138660422,81,64,158,0.504424691200256,2.08965517241379,1.36486486486486,4.71171171171171,222,145
"1148",96,14.33,8,307,560,0.0119222498988738,1.82410423452769,1.82410423452769,1.69999635883375,81,65,161,0.484845399856567,2.1027397260274,1.35840707964602,4.65044247787611,226,146
"1149",96,17.91,9,330,649,0.0119554204660588,1.96666666666667,1.96666666666667,1.77266669458268,86,72,172,0.457970201969147,2.08860759493671,1.35245901639344,4.43852459016393,244,158
"1150",96,20.8,10,343,705,0.0120198455321978,2.05539358600583,2.05539358600583,1.75496877888098,87,76,180,0.461600542068481,2.10429447852761,1.33984375,4.30078125,256,163
"1151",96,21.37,11,346,731,0.0122476334087292,2.11271676300578,2.11271676300578,1.78827717377754,88,78,180,0.458441913127899,2.08433734939759,1.34108527131783,4.27519379844961,258,166
"1152",96,21.5,12,349,753,0.0123999604782136,2.15759312320917,2.15759312320917,1.78717874239867,88,78,183,0.424523204565048,2.10240963855422,1.33716475095785,4.24521072796935,261,166
"1153",97,2.89,1,163,202,0.015299553131864,1.23926380368098,1.23926380368098,1.32935663673885,48,35,80,0.611067533493042,1.96385542168675,1.41739130434783,6.6,115,83
"1154",97,4.41,2,211,284,0.0128187767998195,1.34597156398104,1.34597156398104,1.36778047020215,63,45,103,0.598021268844604,1.9537037037037,1.42567567567568,5.79054054054054,148,108
"1155",97,7.99,3,251,397,0.0126533864541833,1.58167330677291,1.58167330677291,1.50312785867213,72,59,120,0.540800392627716,1.91603053435115,1.40223463687151,5.25139664804469,179,131
"1156",97,8.69,4,268,444,0.012409860808318,1.65671641791045,1.65671641791045,1.55341911758102,75,61,132,0.524769723415375,1.97058823529412,1.38860103626943,5.04663212435233,193,136
"1157",97,9.26,5,280,492,0.0125960061443932,1.75714285714286,1.75714285714286,1.65079181147663,77,65,138,0.496106445789337,1.97183098591549,1.37931034482759,4.88177339901478,203,142
"1158",97,9.39,6,288,524,0.0126790553619822,1.81944444444444,1.81944444444444,1.67846732290357,78,65,145,0.473071157932281,2.01398601398601,1.37142857142857,4.79047619047619,210,143
"1159",97,12.87,7,299,560,0.0125698637516554,1.87290969899666,1.87290969899666,1.69611017852826,79,68,152,0.473081946372986,2.03401360544218,1.35909090909091,4.66818181818182,220,147
"1160",97,16.11,8,316,604,0.0121358247940526,1.91139240506329,1.91139240506329,1.73731954569389,83,72,161,0.451409727334976,2.03870967741935,1.35622317596567,4.51072961373391,233,155
"1161",97,18.33,9,329,670,0.0124175253910594,2.03647416413374,2.03647416413374,1.77992111705406,84,75,170,0.427938282489777,2.06918238993711,1.34285714285714,4.41224489795918,245,159
"1162",97,19.11,10,336,698,0.0124022743425728,2.07738095238095,2.07738095238095,1.76231706244067,85,76,175,0.440520823001862,2.08695652173913,1.33864541832669,4.34262948207171,251,161
"1163",97,20.25,11,339,717,0.0125150547206367,2.11504424778761,2.11504424778761,1.7706587744849,85,76,178,0.435257375240326,2.1055900621118,1.33464566929134,4.30708661417323,254,161
"1164",97,21.5,12,349,753,0.0123999604782136,2.15759312320917,2.15759312320917,1.78717874239867,88,78,183,0.424523204565048,2.10240963855422,1.33716475095785,4.24521072796935,261,166
"1165",98,0.78,1,137,147,0.0157793044224989,1.07299270072993,1.07299270072993,1.13376587282185,42,25,70,0.767758846282959,2.04477611940298,1.44210526315789,6.95789473684211,95,67
"1166",98,1.35,2,185,236,0.0138660399529965,1.27567567567568,1.27567567567568,1.50135561108008,55,38,92,0.618060648441315,1.98924731182796,1.42307692307692,6.03846153846154,130,93
"1167",98,2.87,3,208,289,0.0134243775548123,1.38942307692308,1.38942307692308,1.53978474325082,60,48,100,0.580859839916229,1.92592592592593,1.40540540540541,5.72297297297297,148,108
"1168",98,4.01,4,216,334,0.0143841515934539,1.5462962962963,1.5462962962963,1.58749721100445,62,50,104,0.558826923370361,1.92857142857143,1.4025974025974,5.56493506493506,154,112
"1169",98,4.71,5,239,383,0.0134664744558911,1.60251046025105,1.60251046025105,1.58075323535214,65,51,123,0.524166762828827,2.06034482758621,1.3735632183908,5.32183908045977,174,116
"1170",98,6.93,6,265,460,0.0131503716409377,1.73584905660377,1.73584905660377,1.61761539170446,70,55,140,0.484447032213211,2.12,1.35897435897436,5.07692307692308,195,125
"1171",98,10.41,7,282,501,0.0126448095706822,1.77659574468085,1.77659574468085,1.65351228381833,74,58,150,0.475095719099045,2.13636363636364,1.35576923076923,4.90384615384615,208,132
"1172",98,13.99,8,309,594,0.0124826629680999,1.92233009708738,1.92233009708738,1.72433075845964,81,69,159,0.447973042726517,2.06,1.35526315789474,4.61842105263158,228,150
"1173",98,14.12,9,313,620,0.0126976325059392,1.98083067092652,1.98083067092652,1.72195494195998,81,69,163,0.447505205869675,2.08666666666667,1.34913793103448,4.58189655172414,232,150
"1174",98,17.36,10,325,659,0.0125166191832858,2.02769230769231,2.02769230769231,1.77789131990664,83,72,170,0.423250138759613,2.09677419354839,1.34297520661157,4.45867768595041,242,155
"1175",98,20.25,11,339,717,0.0125150547206367,2.11504424778761,2.11504424778761,1.7706587744849,85,76,178,0.435257375240326,2.1055900621118,1.33464566929134,4.30708661417323,254,161
"1176",98,21.5,12,349,753,0.0123999604782136,2.15759312320917,2.15759312320917,1.78717874239867,88,78,183,0.424523204565048,2.10240963855422,1.33716475095785,4.24521072796935,261,166
"1177",99,0.78,1,137,147,0.0157793044224989,1.07299270072993,1.07299270072993,1.13376587282185,42,25,70,0.767758846282959,2.04477611940298,1.44210526315789,6.95789473684211,95,67
"1178",99,0.91,2,167,203,0.0146454079792223,1.21556886227545,1.21556886227545,1.13905172275589,47,32,88,0.677703976631165,2.11392405063291,1.39166666666667,6.20833333333333,120,79
"1179",99,1.48,3,199,279,0.0141617176793056,1.40201005025126,1.40201005025126,1.46020304603107,55,41,103,0.569693386554718,2.07291666666667,1.38194444444444,5.77777777777778,144,96
"1180",99,5.06,4,248,398,0.0129946454224892,1.60483870967742,1.60483870967742,1.56961313168387,69,54,125,0.522388994693756,2.01626016260163,1.3854748603352,5.22346368715084,179,123
"1181",99,8.54,5,260,441,0.0130977130977131,1.69615384615385,1.69615384615385,1.61314479164966,70,58,132,0.508044540882111,2.03125,1.36842105263158,5.06315789473684,190,128
"1182",99,9.68,6,267,476,0.0134042972600039,1.78277153558052,1.78277153558052,1.6592012842954,72,60,135,0.504980683326721,2.02272727272727,1.36923076923077,4.96410256410256,195,132
"1183",99,11.9,7,292,546,0.0128512921903686,1.86986301369863,1.86986301369863,1.70422324008254,77,64,151,0.436417371034622,2.0709219858156,1.35813953488372,4.7906976744186,215,141
"1184",99,13.15,8,309,591,0.0124196192157357,1.9126213592233,1.9126213592233,1.7280845693422,81,66,162,0.489967942237854,2.10204081632653,1.35526315789474,4.62719298245614,228,147
"1185",99,16.04,9,325,653,0.0124026590693257,2.00923076923077,2.00923076923077,1.72209067144287,82,71,172,0.452349752187729,2.12418300653595,1.33744855967078,4.43621399176955,243,153
"1186",99,19.28,10,335,694,0.0124050406649388,2.07164179104478,2.07164179104478,1.76279126217652,85,74,176,0.429715603590012,2.10691823899371,1.34,4.348,250,159
"1187",99,20.8,11,343,727,0.0123949329105076,2.11953352769679,2.11953352769679,1.78112268408736,87,77,179,0.410857290029526,2.09146341463415,1.33984375,4.28515625,256,164
"1188",99,21.5,12,349,753,0.0123999604782136,2.15759312320917,2.15759312320917,1.78717874239867,88,78,183,0.424523204565048,2.10240963855422,1.33716475095785,4.24521072796935,261,166
"1189",100,1.14,1,114,141,0.0218910107126223,1.23684210526316,1.23684210526316,1.17486110561291,37,25,52,0.668024718761444,1.83870967741935,1.48051948051948,7.28571428571429,77,62
"1190",100,1.71,2,160,226,0.0177672955974843,1.4125,1.4125,1.53223552205032,50,39,71,0.573410212993622,1.79775280898876,1.45454545454545,6.38181818181818,110,89
"1191",100,1.84,3,180,273,0.0169459962756052,1.51666666666667,1.51666666666667,1.54350051361239,51,40,89,0.564223289489746,1.97802197802198,1.3953488372093,6,129,91
"1192",100,3.09,4,212,344,0.0153804882410802,1.62264150943396,1.62264150943396,1.62211578747596,60,48,104,0.516305267810822,1.96296296296296,1.39473684210526,5.59210526315789,152,108
"1193",100,5.31,5,250,425,0.0136546184738956,1.7,1.7,1.69296657485347,69,53,128,0.523186147212982,2.04918032786885,1.38121546961326,5.29834254143646,181,122
"1194",100,6.09,6,263,460,0.0133515223638,1.74904942965779,1.74904942965779,1.65503730246811,71,53,139,0.496864348649979,2.12096774193548,1.36979166666667,5.09895833333333,192,124
"1195",100,7.61,7,278,503,0.013063917097369,1.80935251798561,1.80935251798561,1.67522026840996,75,59,144,0.495549619197845,2.07462686567164,1.36945812807882,4.93596059113301,203,134
"1196",100,10.85,8,292,549,0.0129219036859201,1.88013698630137,1.88013698630137,1.74569860019057,77,63,152,0.501295626163483,2.08571428571429,1.35813953488372,4.77209302325581,215,140
"1197",100,14.33,9,305,585,0.012618636755824,1.91803278688525,1.91803278688525,1.77786536515612,80,66,159,0.468194931745529,2.08904109589041,1.35555555555556,4.63555555555556,225,146
"1198",100,17.91,10,329,669,0.0123989917710727,2.03343465045593,2.03343465045593,1.79927020495613,86,73,170,0.467462539672852,2.06918238993711,1.35390946502058,4.44855967078189,243,159
"1199",100,20.8,11,343,727,0.0123949329105076,2.11953352769679,2.11953352769679,1.78112268408736,87,77,179,0.410857290029526,2.09146341463415,1.33984375,4.28515625,256,164
"1200",100,21.5,12,349,753,0.0123999604782136,2.15759312320917,2.15759312320917,1.78717874239867,88,78,183,0.424523204565048,2.10240963855422,1.33716475095785,4.24521072796935,261,166
