"","replicate","a","a_idx","species","links","connectances","links_per_sp","indegree","sd_gen","S_basal","S_intermediate","S_top","modularity","normalised_outdegree","normalised_indegree","potential_indegree","consumers","resources"
"1",1,2.22,1,171,147,0.0101135190918473,0.859649122807018,0.859649122807018,1.67538613037165,38,18,64,0.519552111625671,3.05357142857143,2.08536585365854,3.10975609756098,82,56
"2",1,2.92,2,204,278,0.0134260600792041,1.36274509803922,1.36274509803922,2.09661728743211,50,26,79,0.453981399536133,2.68421052631579,1.94285714285714,3.86666666666667,105,76
"3",1,4.17,3,233,328,0.0121355631197277,1.40772532188841,1.40772532188841,1.66612929604522,55,30,105,0.507315218448639,2.74117647058824,1.72592592592593,3.37777777777778,135,85
"4",1,4.95,4,249,369,0.0119510299261562,1.48192771084337,1.48192771084337,2.01446557488366,68,37,110,0.514504909515381,2.37142857142857,1.69387755102041,3.25170068027211,147,105
"5",1,5.08,5,256,385,0.0117953431372549,1.50390625,1.50390625,1.90180458898676,64,47,111,0.487373977899551,2.30630630630631,1.62025316455696,3.25949367088608,158,111
"6",1,5.65,6,268,404,0.0112918553300911,1.50746268656716,1.50746268656716,1.61931318088953,68,38,123,0.492301642894745,2.52830188679245,1.66459627329193,3.40372670807453,161,106
"7",1,8.89,7,284,530,0.0131886726720749,1.86619718309859,1.86619718309859,1.78800047772092,77,53,135,0.412924587726593,2.18461538461538,1.51063829787234,3.26595744680851,188,130
"8",1,11.78,8,301,554,0.0122702104097453,1.84053156146179,1.84053156146179,1.54770153415896,80,62,153,0.479336321353912,2.11971830985915,1.4,2.76744186046512,215,142
"9",1,12.92,9,305,579,0.0124892148403796,1.8983606557377,1.8983606557377,1.84563801006099,77,61,151,0.439847767353058,2.21014492753623,1.43867924528302,3.00471698113208,212,138
"10",1,16.4,10,317,593,0.0118396358263786,1.87066246056782,1.87066246056782,1.76778264374349,81,63,159,0.476045727729797,2.20138888888889,1.42792792792793,2.98648648648649,222,144
"11",1,17.92,11,329,677,0.012547260730966,2.05775075987842,2.05775075987842,1.82265522505911,84,73,167,0.433265209197998,2.09554140127389,1.37083333333333,2.94166666666667,240,157
"12",1,21.5,12,349,753,0.0123999604782136,2.15759312320917,2.15759312320917,1.78717874239867,88,78,183,0.424523204565048,2.10240963855422,1.33716475095785,2.88505747126437,261,166
"13",2,0.13,1,110,65,0.0108423686405338,0.590909090909091,0.590909090909091,2.02838015197634,28,3,30,0.683195233345032,3.54838709677419,3.33333333333333,4.60606060606061,33,31
"14",2,0.83,2,171,164,0.0112831097351221,0.95906432748538,0.95906432748538,1.67119099029148,44,18,66,0.599215507507324,2.75806451612903,2.03571428571429,3.01190476190476,84,62
"15",2,3.72,3,217,314,0.0133981908175457,1.44700460829493,1.44700460829493,1.62048762728929,59,38,96,0.507753849029541,2.23711340206186,1.61940298507463,3.17164179104478,134,97
"16",2,4.97,4,235,356,0.0129478086924895,1.51489361702128,1.51489361702128,2.15794587630405,65,37,102,0.448061287403107,2.30392156862745,1.69064748201439,3.07913669064748,139,102
"17",2,8.45,5,257,365,0.0110955739299611,1.42023346303502,1.42023346303502,1.97031535056969,65,50,98,0.508211672306061,2.23478260869565,1.73648648648649,3.09459459459459,148,115
"18",2,9.97,6,279,467,0.01204197931977,1.67383512544803,1.67383512544803,1.81482859416462,65,49,139,0.455978959798813,2.44736842105263,1.48404255319149,3.02659574468085,188,114
"19",2,11.11,7,284,491,0.0122181854377146,1.72887323943662,1.72887323943662,1.78663329691137,72,56,133,0.473345041275024,2.21875,1.5026455026455,3.10582010582011,189,128
"20",2,11.89,8,299,566,0.0127045408632803,1.89297658862876,1.89297658862876,1.54730495139162,73,65,151,0.461558401584625,2.16666666666667,1.38425925925926,2.90740740740741,216,138
"21",2,15.13,9,315,592,0.0119704782125164,1.87936507936508,1.87936507936508,1.91882703760192,83,68,153,0.455160886049271,2.08609271523179,1.42533936651584,2.92307692307692,221,151
"22",2,18.71,10,335,704,0.0125837876485834,2.10149253731343,2.10149253731343,1.80891135811674,83,75,172,0.440992653369904,2.12025316455696,1.35627530364372,2.88259109311741,247,158
"23",2,20.93,11,346,740,0.0123984250649242,2.13872832369942,2.13872832369942,1.7666600371837,86,76,183,0.43266350030899,2.1358024691358,1.33590733590734,2.8957528957529,259,162
"24",2,21.5,12,349,753,0.0123999604782136,2.15759312320917,2.15759312320917,1.78717874239867,88,78,183,0.424523204565048,2.10240963855422,1.33716475095785,2.88505747126437,261,166
"25",3,3.58,1,171,226,0.0155486756105951,1.32163742690058,1.32163742690058,1.99117126485729,44,19,72,0.467577695846558,2.71428571428571,1.87912087912088,4.26373626373626,91,63
"26",3,4.83,2,211,321,0.0144888287068382,1.52132701421801,1.52132701421801,1.96184418828325,47,34,94,0.479299515485764,2.60493827160494,1.6484375,3.3828125,128,81
"27",3,8.31,3,239,429,0.0150838578109068,1.79497907949791,1.79497907949791,1.79798623285956,66,43,108,0.437875270843506,2.19266055045872,1.58278145695364,3.47019867549669,151,109
"28",3,9.45,4,250,315,0.0101204819277108,1.26,1.26,1.62050127420677,65,39,102,0.570450961589813,2.40384615384615,1.77304964539007,2.82269503546099,141,104
"29",3,11.67,5,286,539,0.013225371120108,1.88461538461538,1.88461538461538,1.54656964062953,74,56,149,0.444821566343307,2.2,1.39512195121951,2.85365853658537,205,130
"30",3,13.19,6,297,587,0.0133542633542634,1.97643097643098,1.97643097643098,1.76814034078992,73,60,154,0.443957597017288,2.23308270676692,1.38785046728972,3.01401869158878,214,133
"31",3,16.08,7,315,621,0.0125568698817106,1.97142857142857,1.97142857142857,1.87901141222277,81,68,152,0.440311074256897,2.11409395973154,1.43181818181818,3.00909090909091,220,149
"32",3,16.21,8,321,636,0.0123831775700935,1.98130841121495,1.98130841121495,1.82979219865386,79,64,157,0.431394904851913,2.24475524475525,1.45248868778281,3.1131221719457,221,143
"33",3,16.99,9,331,712,0.0130367115261375,2.15105740181269,2.15105740181269,1.78707504454768,85,70,173,0.438885748386383,2.13548387096774,1.36213991769547,2.97119341563786,243,155
"34",3,17.56,10,334,702,0.0126234018449587,2.10179640718563,2.10179640718563,1.82407684811591,86,71,172,0.457165509462357,2.12738853503185,1.37448559670782,2.95884773662551,243,157
"35",3,20.8,11,343,742,0.0126506743048096,2.16326530612245,2.16326530612245,1.78839590368429,86,77,180,0.416515588760376,2.10429447852761,1.33463035019455,2.91439688715953,257,163
"36",3,21.5,12,349,753,0.0123999604782136,2.15759312320917,2.15759312320917,1.78717874239867,88,78,183,0.424523204565048,2.10240963855422,1.33716475095785,2.88505747126437,261,166
"37",4,2.22,1,171,191,0.013140694874441,1.11695906432749,1.11695906432749,1.62732893590584,36,19,74,0.500041127204895,3.10909090909091,1.83870967741935,3.23655913978495,93,55
"38",4,3,2,199,208,0.0105578397035683,1.04522613065327,1.04522613065327,2.06743773420522,39,25,77,0.503074169158936,3.109375,1.95098039215686,3.43137254901961,102,64
"39",4,6.48,3,233,353,0.0130605298209264,1.51502145922747,1.51502145922747,1.84170400521466,59,33,108,0.463345348834991,2.53260869565217,1.65248226950355,3.21276595744681,141,92
"40",4,7.73,4,261,437,0.0128794577070439,1.67432950191571,1.67432950191571,1.85027102015507,64,47,116,0.45764234662056,2.35135135135135,1.60122699386503,3.4601226993865,163,111
"41",4,10.97,5,276,485,0.0127799736495389,1.75724637681159,1.75724637681159,1.90099391084278,72,52,137,0.497330188751221,2.2258064516129,1.46031746031746,3.01587301587302,189,124
"42",4,11.67,6,287,541,0.0131819400112083,1.88501742160279,1.88501742160279,1.84337134330792,73,54,140,0.422330141067505,2.25984251968504,1.47938144329897,3.22164948453608,194,127
"43",4,13.19,7,303,555,0.0121303521080585,1.83168316831683,1.83168316831683,1.87717851228516,72,63,151,0.443623065948486,2.24444444444444,1.41588785046729,2.96261682242991,214,135
"44",4,14.33,8,307,608,0.012944157033063,1.98045602605863,1.98045602605863,1.89410993535695,81,56,161,0.410970509052277,2.24087591240876,1.4147465437788,2.94470046082949,217,137
"45",4,14.9,9,312,636,0.0131090774177591,2.03846153846154,2.03846153846154,1.57593599853887,80,63,160,0.430244088172913,2.18181818181818,1.39910313901345,2.91928251121076,223,143
"46",4,18.48,10,334,692,0.0124435813058568,2.07185628742515,2.07185628742515,1.7935593286805,80,72,175,0.445930361747742,2.19736842105263,1.35222672064777,2.91497975708502,247,152
"47",4,21.37,11,346,740,0.0123984250649242,2.13872832369942,2.13872832369942,1.79935675074284,87,78,181,0.447505503892899,2.0969696969697,1.33590733590734,2.86100386100386,259,165
"48",4,21.5,12,349,753,0.0123999604782136,2.15759312320917,2.15759312320917,1.78717874239867,88,78,183,0.424523204565048,2.10240963855422,1.33716475095785,2.88505747126437,261,166
"49",5,3.58,1,171,185,0.0127278981768146,1.08187134502924,1.08187134502924,2.23603992198715,45,26,57,0.497253477573395,2.40845070422535,2.06024096385542,3.97590361445783,83,71
"50",5,6.82,2,223,371,0.0149880822526562,1.66367713004484,1.66367713004484,1.75927658627218,57,36,99,0.428426116704941,2.39784946236559,1.65185185185185,3.45925925925926,135,93
"51",5,8.34,3,242,372,0.0127567641713247,1.53719008264463,1.53719008264463,1.82666789182055,53,41,105,0.461628496646881,2.57446808510638,1.65753424657534,3.57534246575342,146,94
"52",5,9.59,4,269,432,0.0119846862342562,1.60594795539033,1.60594795539033,1.92309678110943,62,53,113,0.453625947237015,2.33913043478261,1.62048192771084,3.29518072289157,166,115
"53",5,10.73,5,276,502,0.0132279314888011,1.81884057971015,1.81884057971015,1.85691602640951,70,51,130,0.455425292253494,2.28099173553719,1.52486187845304,3.28729281767956,181,121
"54",5,11.3,6,285,483,0.011934766493699,1.69473684210526,1.69473684210526,1.54554734075305,76,46,147,0.508605182170868,2.33606557377049,1.47668393782383,2.93264248704663,193,122
"55",5,14.78,7,297,558,0.0126945126945127,1.87878787878788,1.87878787878788,1.83172312128438,71,58,148,0.427661865949631,2.30232558139535,1.44174757281553,3.00970873786408,206,129
"56",5,17.67,8,318,618,0.0122611749300637,1.94339622641509,1.94339622641509,1.80322601056429,78,67,161,0.459825813770294,2.19310344827586,1.39473684210526,2.97368421052632,228,145
"57",5,17.8,9,324,677,0.0129381187172725,2.08950617283951,2.08950617283951,1.79156163061066,85,70,164,0.426838546991348,2.09032258064516,1.38461538461538,3.02564102564103,234,155
"58",5,18.58,10,332,661,0.012029993084119,1.99096385542169,1.99096385542169,1.79997633405458,82,70,170,0.421631157398224,2.18421052631579,1.38333333333333,2.9125,240,152
"59",5,19.28,11,338,723,0.0126946780678805,2.13905325443787,2.13905325443787,1.81873036200481,87,74,173,0.43196764588356,2.09937888198758,1.36842105263158,2.96761133603239,247,161
"60",5,21.5,12,349,753,0.0123999604782136,2.15759312320917,2.15759312320917,1.78717874239867,88,78,183,0.424523204565048,2.10240963855422,1.33716475095785,2.88505747126437,261,166
"61",6,3.58,1,171,155,0.0106639146886825,0.906432748538012,0.906432748538012,1.64616957605295,38,21,65,0.587575495243073,2.89830508474576,1.98837209302326,2.95348837209302,86,59
"62",6,3.71,2,202,220,0.010836904585981,1.08910891089109,1.08910891089109,1.76223045885712,53,27,71,0.552438020706177,2.525,2.06122448979592,3.56122448979592,98,80
"63",6,6.95,3,238,359,0.0127291422898273,1.50840336134454,1.50840336134454,1.66309675978457,65,43,104,0.48237133026123,2.2037037037037,1.61904761904762,3.00680272108844,147,108
"64",6,10.43,4,257,427,0.0129803015564202,1.66147859922179,1.66147859922179,1.60724457975685,68,48,129,0.485331416130066,2.21551724137931,1.45197740112994,2.84745762711864,177,116
"65",6,11.13,5,272,433,0.0117484263077925,1.59191176470588,1.59191176470588,1.87239618493961,66,50,122,0.475043892860413,2.3448275862069,1.58139534883721,3.20348837209302,172,116
"66",6,14.02,6,296,438,0.0100320659642694,1.47972972972973,1.47972972972973,1.52483894362129,79,55,141,0.540634632110596,2.2089552238806,1.51020408163265,2.62244897959184,196,134
"67",6,15.54,7,308,564,0.0119294386395364,1.83116883116883,1.83116883116883,1.60421104144644,79,63,151,0.490743368864059,2.16901408450704,1.4392523364486,2.91588785046729,214,142
"68",6,16.79,8,320,640,0.0125391849529781,2,2,1.84764528615432,82,68,158,0.441036432981491,2.13333333333333,1.41592920353982,3.06194690265487,226,150
"69",6,19.01,9,334,691,0.0124255992519466,2.0688622754491,2.0688622754491,1.816573634172,85,72,173,0.420985281467438,2.12738853503185,1.36326530612245,2.95918367346939,245,157
"70",6,20.15,10,337,720,0.0127172530733362,2.13649851632047,2.13649851632047,1.81703232370984,86,75,175,0.440863221883774,2.09316770186335,1.348,2.916,250,161
"71",6,20.72,11,342,695,0.0119188489307335,2.03216374269006,2.03216374269006,1.7865363937158,86,74,180,0.450513929128647,2.1375,1.34645669291339,2.83464566929134,254,160
"72",6,21.5,12,349,753,0.0123999604782136,2.15759312320917,2.15759312320917,1.78717874239867,88,78,183,0.424523204565048,2.10240963855422,1.33716475095785,2.88505747126437,261,166
"73",7,1.52,1,120,78,0.0109243697478992,0.65,0.65,2.42351039104107,22,10,34,0.55711704492569,3.75,2.72727272727273,5.09090909090909,44,32
"74",7,5.1,2,202,245,0.0120683710162061,1.21287128712871,1.21287128712871,2.10312772863719,48,27,81,0.43265300989151,2.69333333333333,1.87037037037037,3.57407407407407,108,75
"75",7,6.24,3,220,306,0.0127023661270237,1.39090909090909,1.39090909090909,1.62905633864007,49,34,90,0.491087824106216,2.65060240963855,1.7741935483871,3.37096774193548,124,83
"76",7,9.13,4,262,445,0.0130151209382586,1.69847328244275,1.69847328244275,1.99182729176313,69,51,116,0.434306263923645,2.18333333333333,1.5688622754491,3.30538922155689,167,120
"77",7,12.37,5,284,496,0.0123426068780172,1.74647887323944,1.74647887323944,1.81377424452659,70,55,135,0.459413230419159,2.272,1.49473684210526,3.12105263157895,190,125
"78",7,12.5,6,292,498,0.011721508261545,1.70547945205479,1.70547945205479,1.63355410935785,72,58,140,0.497139155864716,2.24615384615385,1.47474747474747,2.95454545454545,198,130
"79",7,13.28,7,304,597,0.0129624804585722,1.96381578947368,1.96381578947368,1.80676867692371,72,63,152,0.460219860076904,2.25185185185185,1.41395348837209,3.07441860465116,215,135
"80",7,13.85,8,308,606,0.0128178010914167,1.96753246753247,1.96753246753247,1.77388660378121,80,62,154,0.439544320106506,2.16901408450704,1.42592592592593,3.13425925925926,216,142
"81",7,15.1,9,322,624,0.0120740697741917,1.93788819875776,1.93788819875776,1.77843654003751,80,68,167,0.43656387925148,2.17567567567568,1.37021276595745,2.85957446808511,235,148
"82",7,17.32,10,334,695,0.0124975274675873,2.08083832335329,2.08083832335329,1.80446680264061,78,74,174,0.44214278459549,2.19736842105263,1.34677419354839,2.91532258064516,248,152
"83",7,18.02,11,340,726,0.012597605413847,2.13529411764706,2.13529411764706,1.78661996160435,87,76,174,0.421247571706772,2.08588957055215,1.36,2.928,250,163
"84",7,21.5,12,349,753,0.0123999604782136,2.15759312320917,2.15759312320917,1.78717874239867,88,78,183,0.424523204565048,2.10240963855422,1.33716475095785,2.88505747126437,261,166
"85",8,2.89,1,163,150,0.0113610543058396,0.920245398773006,0.920245398773006,1.46878317170608,37,22,63,0.696688830852509,2.76271186440678,1.91764705882353,3.05882352941176,85,59
"86",8,4.14,2,200,284,0.0142713567839196,1.42,1.42,1.83742613190239,51,29,88,0.478829860687256,2.5,1.70940170940171,3.4957264957265,117,80
"87",8,4.84,3,222,269,0.0109657168480698,1.21171171171171,1.21171171171171,1.61950383476239,56,33,95,0.538148999214172,2.49438202247191,1.734375,3.3359375,128,89
"88",8,7.06,4,261,395,0.011641615089891,1.51340996168582,1.51340996168582,1.9443035692551,69,43,115,0.485402971506119,2.33035714285714,1.65189873417722,3.27215189873418,158,112
"89",8,8.2,5,269,485,0.0134550296842923,1.80297397769517,1.80297397769517,1.88043277733412,60,50,130,0.421022415161133,2.44545454545455,1.49444444444444,3.16666666666667,180,110
"90",8,11.78,6,300,593,0.013221850613155,1.97666666666667,1.97666666666667,1.84083455995813,78,56,152,0.438020586967468,2.23880597014925,1.44230769230769,3.12980769230769,208,134
"91",8,12.35,7,309,596,0.0125246921363426,1.92880258899676,1.92880258899676,1.87780655825832,77,59,157,0.422334581613541,2.27205882352941,1.43055555555556,2.97685185185185,216,136
"92",8,13.87,8,319,641,0.0126377634510361,2.00940438871473,2.00940438871473,1.80838365006991,83,66,162,0.428087413311005,2.14093959731544,1.39912280701754,3.02631578947368,228,149
"93",8,17.35,9,328,663,0.0123629447303647,2.02134146341463,2.02134146341463,1.85730297590627,81,68,170,0.445925444364548,2.20134228187919,1.3781512605042,2.95378151260504,238,149
"94",8,18.13,10,337,693,0.0122403560830861,2.05637982195846,2.05637982195846,1.82608627293907,87,73,175,0.45816445350647,2.10625,1.35887096774194,2.83467741935484,248,160
"95",8,21.37,11,346,744,0.0124654435787886,2.15028901734104,2.15028901734104,1.77046216767846,87,77,181,0.430211395025253,2.10975609756098,1.34108527131783,2.90697674418605,258,164
"96",8,21.5,12,349,753,0.0123999604782136,2.15759312320917,2.15759312320917,1.78717874239867,88,78,183,0.424523204565048,2.10240963855422,1.33716475095785,2.88505747126437,261,166
"97",9,3.24,1,156,141,0.0116625310173697,0.903846153846154,0.903846153846154,1.88422322759157,40,18,50,0.563226163387299,2.68965517241379,2.29411764705882,3.83823529411765,68,58
"98",9,4.76,2,196,264,0.0138147566718995,1.3469387755102,1.3469387755102,1.9128039520084,49,33,85,0.536121129989624,2.39024390243902,1.66101694915254,3.27966101694915,118,82
"99",9,4.89,3,215,216,0.00938926320365138,1.0046511627907,1.0046511627907,1.5826124859287,50,20,88,0.540305614471436,3.07142857142857,1.99074074074074,3.7037037037037,108,70
"100",9,8.37,4,237,406,0.0145176285489523,1.71308016877637,1.71308016877637,1.95257861882021,59,44,104,0.427682638168335,2.30097087378641,1.60135135135135,3.5,148,103
"101",9,10.59,5,263,520,0.0150930252808173,1.97718631178707,1.97718631178707,1.83847066735732,68,52,128,0.424794733524323,2.19166666666667,1.46111111111111,3.35555555555556,180,120
"102",9,14.17,6,295,527,0.0121526576732388,1.7864406779661,1.7864406779661,1.75550782876841,72,56,141,0.474430084228516,2.3046875,1.49746192893401,3.23350253807107,197,128
"103",9,15.42,7,312,622,0.0128205128205128,1.99358974358974,1.99358974358974,1.7975763601074,83,66,155,0.44135719537735,2.09395973154362,1.41176470588235,3,221,149
"104",9,16.56,8,315,578,0.0116873925791123,1.83492063492063,1.83492063492063,1.83642411950908,81,67,158,0.469410389661789,2.12837837837838,1.4,2.92888888888889,225,148
"105",9,17.13,9,321,649,0.012636292834891,2.02180685358255,2.02180685358255,1.80185015714631,83,68,165,0.435914188623428,2.12582781456954,1.37768240343348,2.92274678111588,233,151
"106",9,17.83,10,329,654,0.0121209874712729,1.98784194528875,1.98784194528875,1.81973699337158,86,70,170,0.409452795982361,2.10897435897436,1.37083333333333,2.74583333333333,240,156
"107",9,20.72,11,342,727,0.0124676304642349,2.12573099415205,2.12573099415205,1.78681306028253,86,75,179,0.436912626028061,2.12422360248447,1.34645669291339,2.90157480314961,254,161
"108",9,21.5,12,349,753,0.0123999604782136,2.15759312320917,2.15759312320917,1.78717874239867,88,78,183,0.424523204565048,2.10240963855422,1.33716475095785,2.88505747126437,261,166
"109",10,0.13,1,110,75,0.0125104253544621,0.681818181818182,0.681818181818182,1.53801969660859,24,11,33,0.647644400596619,3.14285714285714,2.5,4.95454545454545,44,35
"110",10,0.91,2,167,169,0.0121924825048698,1.01197604790419,1.01197604790419,2.12820926867788,34,18,58,0.42570286989212,3.21153846153846,2.19736842105263,4.21052631578947,76,52
"111",10,3.13,3,216,329,0.0141688199827735,1.52314814814815,1.52314814814815,1.92683951176563,55,32,96,0.488756626844406,2.48275862068966,1.6875,3.578125,128,87
"112",10,6.02,4,251,357,0.0113784860557769,1.42231075697211,1.42231075697211,1.69045940223597,66,41,117,0.488913208246231,2.34579439252336,1.58860759493671,2.88607594936709,158,107
"113",10,9.6,5,287,508,0.0123778660364026,1.77003484320557,1.77003484320557,1.60311759618869,75,49,147,0.476081550121307,2.31451612903226,1.46428571428571,2.99489795918367,196,124
"114",10,11.12,6,301,557,0.0123366555924695,1.85049833887043,1.85049833887043,1.88861985136089,70,63,144,0.447774231433868,2.26315789473684,1.45410628019324,2.97101449275362,207,133
"115",10,14.6,7,312,570,0.0117487014593124,1.82692307692308,1.82692307692308,1.59618770736931,78,62,162,0.491586625576019,2.22857142857143,1.39285714285714,2.82589285714286,224,140
"116",10,17.84,8,324,680,0.0129954515919428,2.09876543209877,2.09876543209877,1.8207922072404,83,72,167,0.423306673765182,2.09032258064516,1.35564853556485,2.98326359832636,239,155
"117",10,18.54,9,332,713,0.0129763768063189,2.14759036144578,2.14759036144578,1.82736201651637,84,73,172,0.393067836761475,2.11464968152866,1.35510204081633,2.93469387755102,245,157
"118",10,19.11,10,336,710,0.0126154939587775,2.11309523809524,2.11309523809524,1.75395234180122,83,72,175,0.428167045116425,2.16774193548387,1.36032388663968,2.97570850202429,247,155
"119",10,20.25,11,339,732,0.012776875949102,2.15929203539823,2.15929203539823,1.80446360509301,87,73,178,0.427048802375793,2.11875,1.35059760956175,2.95219123505976,251,160
"120",10,21.5,12,349,753,0.0123999604782136,2.15759312320917,2.15759312320917,1.78717874239867,88,78,183,0.424523204565048,2.10240963855422,1.33716475095785,2.88505747126437,261,166
"121",11,0.13,1,110,105,0.0175145954962469,0.954545454545455,0.954545454545455,1.86318761748315,29,14,35,0.529115617275238,2.55813953488372,2.24489795918367,3.75510204081633,49,43
"122",11,1.27,2,147,171,0.0159351411797596,1.16326530612245,1.16326530612245,2.04977031148734,37,18,52,0.504377365112305,2.67272727272727,2.1,4.24285714285714,70,55
"123",11,1.84,3,180,186,0.0115456238361266,1.03333333333333,1.03333333333333,1.51345991899663,45,21,74,0.608856558799744,2.72727272727273,1.89473684210526,3.12631578947368,95,66
"124",11,4.73,4,229,283,0.0108404198268597,1.23580786026201,1.23580786026201,1.93166016108956,56,29,89,0.444855064153671,2.69411764705882,1.94067796610169,3.77966101694915,118,85
"125",11,5.98,5,253,365,0.0114499027542506,1.44268774703557,1.44268774703557,1.59982112443474,70,45,110,0.522394478321075,2.2,1.63225806451613,3.05806451612903,155,115
"126",11,9.22,6,273,530,0.014274940745529,1.94139194139194,1.94139194139194,1.82996661152617,73,47,138,0.421909987926483,2.275,1.47567567567568,3.2972972972973,185,120
"127",11,9.92,7,280,517,0.0132360471070148,1.84642857142857,1.84642857142857,1.89240018133224,65,57,126,0.394649595022202,2.29508196721311,1.53005464480874,3.27868852459016,183,122
"128",11,12.14,8,297,536,0.0121940121940122,1.8047138047138,1.8047138047138,1.85647724958053,70,58,147,0.441323608160019,2.3203125,1.44878048780488,3.05365853658537,205,128
"129",11,13.66,9,310,570,0.0119010335108049,1.83870967741935,1.83870967741935,1.85168231221617,76,63,146,0.476897478103638,2.23021582733813,1.48325358851675,3.03827751196172,209,139
"130",11,17.14,10,321,608,0.0118380062305296,1.89408099688474,1.89408099688474,1.86578188176706,82,63,153,0.462967723608017,2.21379310344828,1.48611111111111,3.02314814814815,216,145
"131",11,20.72,11,342,701,0.012021745468265,2.04970760233918,2.04970760233918,1.79230335603521,86,75,175,0.427108436822891,2.12422360248447,1.368,2.924,250,161
"132",11,21.5,12,349,753,0.0123999604782136,2.15759312320917,2.15759312320917,1.78717874239867,88,78,183,0.424523204565048,2.10240963855422,1.33716475095785,2.88505747126437,261,166
"133",12,0.78,1,137,94,0.0100901674538429,0.686131386861314,0.686131386861314,1.75634901710638,31,10,43,0.611702144145966,3.34146341463415,2.58490566037736,3.9622641509434,53,41
"134",12,4.36,2,213,287,0.012711489060147,1.34741784037559,1.34741784037559,2.08566838449326,52,30,93,0.484915435314178,2.59756097560976,1.73170731707317,3.26016260162602,123,82
"135",12,7.84,3,238,365,0.0129418856150055,1.53361344537815,1.53361344537815,1.60684944072094,60,36,112,0.459027945995331,2.47916666666667,1.60810810810811,3.12162162162162,148,96
"136",12,8.54,4,256,407,0.012469362745098,1.58984375,1.58984375,1.86087028235273,59,40,129,0.470337867736816,2.58585858585859,1.51479289940828,3.1301775147929,169,99
"137",12,11.78,5,281,465,0.0118200305033045,1.65480427046263,1.65480427046263,1.89366206019346,72,51,127,0.465554416179657,2.28455284552846,1.57865168539326,3.16292134831461,178,123
"138",12,14,6,300,553,0.012329988851728,1.84333333333333,1.84333333333333,1.79723876343078,76,54,152,0.437201023101807,2.30769230769231,1.45631067961165,3.04368932038835,206,130
"139",12,15.14,7,306,535,0.0114646951676846,1.7483660130719,1.7483660130719,1.74889553635057,75,60,149,0.464106887578964,2.26666666666667,1.46411483253589,3.03349282296651,209,135
"140",12,15.27,8,310,579,0.0120889445662386,1.86774193548387,1.86774193548387,1.61099780002559,81,61,156,0.45351254940033,2.1830985915493,1.42857142857143,2.97695852534562,217,142
"141",12,18.16,9,326,645,0.0121755545068429,1.97852760736196,1.97852760736196,1.8210137765142,84,67,168,0.443163275718689,2.15894039735099,1.38723404255319,2.91063829787234,235,151
"142",12,18.73,10,331,696,0.0127437517165614,2.10271903323263,2.10271903323263,1.82291249787191,83,71,172,0.383340954780579,2.14935064935065,1.36213991769547,2.94238683127572,243,154
"143",12,20.25,11,339,725,0.0126546927091515,2.13864306784661,2.13864306784661,1.80889568256444,84,76,175,0.422584503889084,2.11875,1.35059760956175,2.91633466135458,251,160
"144",12,21.5,12,349,753,0.0123999604782136,2.15759312320917,2.15759312320917,1.78717874239867,88,78,183,0.424523204565048,2.10240963855422,1.33716475095785,2.88505747126437,261,166
"145",13,1.14,1,114,67,0.0104021114733737,0.587719298245614,0.587719298245614,1.48110400947169,30,9,38,0.796836733818054,2.92307692307692,2.42553191489362,2.97872340425532,47,39
"146",13,2.66,2,164,197,0.0147388897201855,1.20121951219512,1.20121951219512,1.49597783256131,35,22,73,0.560746192932129,2.87719298245614,1.72631578947368,3.23157894736842,95,57
"147",13,6.14,3,196,256,0.013396127681842,1.30612244897959,1.30612244897959,1.66988596335468,41,28,77,0.476112365722656,2.84057971014493,1.86666666666667,3.82857142857143,105,69
"148",13,6.27,4,211,249,0.0112389979688558,1.18009478672986,1.18009478672986,1.79201822266314,58,24,83,0.528362452983856,2.57317073170732,1.97196261682243,3.62616822429907,107,82
"149",13,9.51,5,244,439,0.0148080685421305,1.79918032786885,1.79918032786885,1.87695109616531,66,46,119,0.475189566612244,2.17857142857143,1.47878787878788,3.21818181818182,165,112
"150",13,12.4,6,277,466,0.0121906555747397,1.68231046931408,1.68231046931408,1.63104750370052,75,47,130,0.463986724615097,2.27049180327869,1.56497175141243,3.12429378531073,177,122
"151",13,13.18,7,291,579,0.013722004976893,1.98969072164948,1.98969072164948,1.80898196153253,74,62,144,0.418439239263535,2.13970588235294,1.4126213592233,3.20388349514563,206,136
"152",13,16.76,8,315,666,0.013466787989081,2.11428571428571,2.11428571428571,1.82321778699807,80,70,162,0.426357626914978,2.1,1.35775862068966,2.94827586206897,232,150
"153",13,18.98,9,327,655,0.0122887000243898,2.00305810397554,2.00305810397554,1.84511674859852,84,70,158,0.427062541246414,2.12337662337662,1.43421052631579,2.99561403508772,228,154
"154",13,20.23,10,340,728,0.0126323095609925,2.14117647058824,2.14117647058824,1.79707398504633,87,73,178,0.407364159822464,2.125,1.35458167330677,2.93227091633466,251,160
"155",13,20.93,11,346,728,0.0121973695233308,2.10404624277457,2.10404624277457,1.77909819731371,87,77,181,0.43934154510498,2.10975609756098,1.34108527131783,2.87984496124031,258,164
"156",13,21.5,12,349,753,0.0123999604782136,2.15759312320917,2.15759312320917,1.78717874239867,88,78,183,0.424523204565048,2.10240963855422,1.33716475095785,2.88505747126437,261,166
"157",14,3.58,1,171,190,0.0130718954248366,1.11111111111111,1.11111111111111,2.03235592065841,32,25,65,0.49020779132843,3,1.9,3.36666666666667,90,57
"158",14,4.83,2,211,228,0.0102911306702776,1.08056872037915,1.08056872037915,2.20264230033519,58,23,83,0.576206147670746,2.60493827160494,1.99056603773585,3.5188679245283,106,81
"159",14,5.53,3,234,404,0.0148197058068303,1.72649572649573,1.72649572649573,1.86375923382745,64,42,107,0.468152582645416,2.20754716981132,1.57046979865772,3.53020134228188,149,106
"160",14,7.75,4,275,525,0.0139349701393497,1.90909090909091,1.90909090909091,1.82353756193381,70,51,138,0.445734232664108,2.27272727272727,1.45502645502646,3.1957671957672,189,121
"161",14,7.88,5,282,395,0.00996946063955983,1.40070921985816,1.40070921985816,1.4886228097381,70,41,140,0.561535000801086,2.54054054054054,1.55801104972376,2.74585635359116,181,111
"162",14,11.36,6,294,525,0.0121891760117016,1.78571428571429,1.78571428571429,1.80128736671149,72,55,150,0.452939689159393,2.31496062992126,1.43414634146341,2.93658536585366,205,127
"163",14,11.93,7,304,530,0.0115077297203405,1.74342105263158,1.74342105263158,1.72799192110669,74,55,152,0.461162358522415,2.35658914728682,1.46859903381643,3.02415458937198,207,129
"164",14,13.45,8,314,638,0.0129830487780061,2.03184713375796,2.03184713375796,1.83216942794295,82,67,156,0.451523721218109,2.10738255033557,1.40807174887892,3.08071748878924,223,149
"165",14,16.69,9,326,674,0.0127229825389335,2.06748466257669,2.06748466257669,1.81463200800709,82,73,159,0.433212339878082,2.10322580645161,1.4051724137931,3,232,155
"166",14,17.47,10,334,713,0.0128212044379709,2.13473053892216,2.13473053892216,1.82548638073202,84,77,173,0.429244339466095,2.07453416149068,1.336,2.888,250,161
"167",14,18.61,11,337,733,0.0129468701427158,2.17507418397626,2.17507418397626,1.77295065546902,84,72,178,0.41676452755928,2.16025641025641,1.348,2.956,250,156
"168",14,21.5,12,349,753,0.0123999604782136,2.15759312320917,2.15759312320917,1.78717874239867,88,78,183,0.424523204565048,2.10240963855422,1.33716475095785,2.88505747126437,261,166
"169",15,0.57,1,142,125,0.0124862651083808,0.880281690140845,0.880281690140845,1.84757761283822,34,10,50,0.461887985467911,3.22727272727273,2.36666666666667,4.4,60,44
"170",15,1.82,2,186,207,0.0120313862249346,1.11290322580645,1.11290322580645,2.12495170947334,46,25,64,0.462776243686676,2.61971830985916,2.08988764044944,3.97752808988764,89,71
"171",15,4.04,3,236,373,0.0134511359538406,1.58050847457627,1.58050847457627,1.90907229459329,55,38,106,0.461686581373215,2.53763440860215,1.63888888888889,3.36111111111111,144,93
"172",15,5.18,4,241,394,0.0136237897648686,1.63485477178423,1.63485477178423,2.01166859972307,66,42,106,0.434538394212723,2.23148148148148,1.62837837837838,3.47972972972973,148,108
"173",15,8.76,5,283,457,0.0114527729744631,1.61484098939929,1.61484098939929,1.62046182740918,76,53,125,0.447976738214493,2.1937984496124,1.58988764044944,3.08988764044944,178,129
"174",15,12.24,6,294,498,0.0115623041025284,1.69387755102041,1.69387755102041,1.82840344236731,75,57,147,0.474679857492447,2.22727272727273,1.44117647058824,2.91176470588235,204,132
"175",15,13.76,7,304,555,0.0120505471599792,1.82565789473684,1.82565789473684,1.84929142401365,78,57,148,0.466350138187408,2.25185185185185,1.48292682926829,3.13170731707317,205,135
"176",15,14.46,8,314,624,0.0126981542907145,1.98726114649682,1.98726114649682,1.86511040181306,83,65,150,0.438603013753891,2.12162162162162,1.46046511627907,3.10697674418605,215,148
"177",15,17.35,9,328,682,0.0127172372641158,2.07926829268293,2.07926829268293,1.82137424380173,80,71,169,0.429144680500031,2.17218543046358,1.36666666666667,2.96666666666667,240,151
"178",15,17.48,10,332,705,0.0128307793105959,2.12349397590361,2.12349397590361,1.7699837682875,87,68,170,0.397348254919052,2.14193548387097,1.39495798319328,3.05042016806723,238,155
"179",15,20.72,11,342,718,0.0123132856579376,2.09941520467836,2.09941520467836,1.82039725229318,83,75,179,0.427441775798798,2.16455696202532,1.34645669291339,2.89370078740157,254,158
"180",15,21.5,12,349,753,0.0123999604782136,2.15759312320917,2.15759312320917,1.78717874239867,88,78,183,0.424523204565048,2.10240963855422,1.33716475095785,2.88505747126437,261,166
"181",16,3.58,1,171,142,0.00976952184382525,0.830409356725146,0.830409356725146,2.12243273203375,27,16,61,0.556982815265656,3.97674418604651,2.22077922077922,4.46753246753247,77,43
"182",16,4.28,2,213,277,0.0122685800336611,1.30046948356808,1.30046948356808,1.63697335397155,51,32,97,0.530555605888367,2.56626506024096,1.65116279069767,3.2015503875969,129,83
"183",16,5.53,3,234,393,0.0144161989655552,1.67948717948718,1.67948717948718,1.81413559635157,59,44,105,0.464946359395981,2.27184466019417,1.57046979865772,3.57046979865772,149,103
"184",16,8.77,4,268,444,0.012409860808318,1.65671641791045,1.65671641791045,1.81435583308031,63,53,116,0.475260764360428,2.31034482758621,1.58579881656805,3.3905325443787,169,116
"185",16,10.29,5,285,506,0.0125030887076847,1.77543859649123,1.77543859649123,1.68297610002122,71,51,143,0.460808247327805,2.33606557377049,1.46907216494845,3.30412371134021,194,122
"186",16,12.51,6,305,559,0.0120578084555651,1.8327868852459,1.8327868852459,1.76591569273269,77,57,151,0.448142409324646,2.27611940298507,1.46634615384615,3.1875,208,134
"187",16,13.65,7,310,621,0.0129658628249295,2.00322580645161,2.00322580645161,1.83931735867879,75,66,158,0.441301643848419,2.19858156028369,1.38392857142857,2.94196428571429,224,141
"188",16,17.13,8,319,645,0.0127166262494825,2.02194357366771,2.02194357366771,1.77604579408094,80,68,157,0.401836484670639,2.15540540540541,1.41777777777778,3.04888888888889,225,148
"189",16,20.02,9,333,721,0.0130431636455733,2.16516516516517,2.16516516516517,1.80056967512607,85,72,173,0.415968507528305,2.12101910828025,1.35918367346939,2.97551020408163,245,157
"190",16,20.8,10,343,729,0.0124290317630812,2.12536443148688,2.12536443148688,1.79102673888161,85,74,179,0.422886073589325,2.15723270440252,1.35573122529644,2.91304347826087,253,159
"191",16,21.37,11,346,750,0.0125659713495853,2.16763005780347,2.16763005780347,1.78592087109423,88,78,180,0.421334236860275,2.08433734939759,1.34108527131783,2.90697674418605,258,166
"192",16,21.5,12,349,753,0.0123999604782136,2.15759312320917,2.15759312320917,1.78717874239867,88,78,183,0.424523204565048,2.10240963855422,1.33716475095785,2.88505747126437,261,166
"193",17,2.22,1,171,229,0.0157550739594083,1.33918128654971,1.33918128654971,2.07786889635516,34,23,72,0.414551585912704,3,1.8,3.72631578947368,95,57
"194",17,2.35,2,195,244,0.0128998149616706,1.25128205128205,1.25128205128205,1.97156610773194,50,22,80,0.487856090068817,2.70833333333333,1.91176470588235,4.14705882352941,102,72
"195",17,3.49,3,206,329,0.0155813402794222,1.59708737864078,1.59708737864078,1.89087967084826,55,34,87,0.432091355323792,2.31460674157303,1.70247933884298,3.71900826446281,121,89
"196",17,4.27,4,225,350,0.0138888888888889,1.55555555555556,1.55555555555556,2.03087502145496,60,40,96,0.453195929527283,2.25,1.65441176470588,3.48529411764706,136,100
"197",17,7.51,5,247,407,0.0133965307264409,1.64777327935223,1.64777327935223,1.93092645078897,67,44,108,0.425272703170776,2.22522522522523,1.625,3.34210526315789,152,111
"198",17,8.21,6,264,372,0.0107155202212236,1.40909090909091,1.40909090909091,1.70936381230532,62,45,114,0.503916680812836,2.46728971962617,1.66037735849057,3.24528301886792,159,107
"199",17,9.73,7,282,483,0.0121905050352086,1.71276595744681,1.71276595744681,1.87295779636066,77,57,126,0.46676442027092,2.1044776119403,1.54098360655738,3.02185792349727,183,134
"200",17,13.21,8,296,516,0.0118185982592762,1.74324324324324,1.74324324324324,1.8657014734912,76,62,137,0.473007172346115,2.14492753623188,1.48743718592965,3.03517587939698,199,138
"201",17,14.46,9,310,538,0.0112329053137071,1.73548387096774,1.73548387096774,1.77684261339805,67,56,148,0.446671843528748,2.52032520325203,1.51960784313725,3.06372549019608,204,123
"202",17,17.35,10,326,672,0.0126852288815479,2.06134969325153,2.06134969325153,1.8232639965885,84,71,168,0.423187077045441,2.10322580645161,1.36401673640167,2.88702928870293,239,155
"203",17,20.93,11,346,748,0.0125324620926531,2.16184971098266,2.16184971098266,1.78907772130255,88,77,181,0.420123934745789,2.0969696969697,1.34108527131783,2.90697674418605,258,165
"204",17,21.5,12,349,753,0.0123999604782136,2.15759312320917,2.15759312320917,1.78717874239867,88,78,183,0.424523204565048,2.10240963855422,1.33716475095785,2.88505747126437,261,166
"205",18,0.57,1,142,139,0.0138847268005194,0.97887323943662,0.97887323943662,1.71405428160193,41,15,47,0.573986887931824,2.53571428571429,2.29032258064516,3.95161290322581,62,56
"206",18,2.79,2,204,239,0.0115425480537042,1.17156862745098,1.17156862745098,2.06399532962771,51,28,77,0.506153583526611,2.58227848101266,1.94285714285714,3.71428571428571,105,79
"207",18,4.04,3,236,348,0.0125495852866931,1.47457627118644,1.47457627118644,1.63553127245683,54,40,113,0.479269862174988,2.51063829787234,1.54248366013072,3.15686274509804,153,94
"208",18,5.56,4,255,377,0.0116411919098348,1.47843137254902,1.47843137254902,1.88831366422914,62,48,111,0.465995669364929,2.31818181818182,1.60377358490566,3.25157232704403,159,110
"209",18,9.04,5,272,511,0.0138647710006512,1.87867647058824,1.87867647058824,1.89948385600572,73,49,132,0.416088730096817,2.22950819672131,1.50276243093923,3.1878453038674,181,122
"210",18,9.17,6,279,475,0.0122482659034063,1.70250896057348,1.70250896057348,1.60367135930446,72,56,128,0.498056530952454,2.1796875,1.51630434782609,3.07065217391304,184,128
"211",18,12.75,7,306,583,0.0124933033322619,1.90522875816993,1.90522875816993,1.83705014441168,71,60,148,0.443849384784698,2.33587786259542,1.47115384615385,3.07211538461538,208,131
"212",18,15.99,8,318,627,0.0124397357300161,1.97169811320755,1.97169811320755,1.8129983778563,78,67,160,0.439845442771912,2.19310344827586,1.40088105726872,3.02643171806167,227,145
"213",18,16.77,9,326,663,0.0125153374233129,2.03374233128834,2.03374233128834,1.79820279972499,83,66,167,0.416837871074677,2.18791946308725,1.39914163090129,3.01287553648069,233,149
"214",18,17.91,10,329,671,0.012436059011046,2.03951367781155,2.03951367781155,1.80446933293764,79,69,169,0.425112366676331,2.22297297297297,1.38235294117647,2.98319327731092,238,148
"215",18,20.8,11,343,723,0.0123267352053603,2.10787172011662,2.10787172011662,1.78709774465586,86,74,178,0.424386262893677,2.14375,1.36111111111111,2.92857142857143,252,160
"216",18,21.5,12,349,753,0.0123999604782136,2.15759312320917,2.15759312320917,1.78717874239867,88,78,183,0.424523204565048,2.10240963855422,1.33716475095785,2.88505747126437,261,166
"217",19,2.22,1,171,206,0.0141726866185071,1.2046783625731,1.2046783625731,1.64034392218925,38,24,71,0.516436517238617,2.75806451612903,1.8,3.02105263157895,95,62
"218",19,3.74,2,207,229,0.0107405844003565,1.10628019323672,1.10628019323672,1.51892572578159,42,29,84,0.514511525630951,2.91549295774648,1.83185840707965,3.43362831858407,113,71
"219",19,4.52,3,227,335,0.0130599196912401,1.47577092511013,1.47577092511013,1.69049823394612,58,38,103,0.471258610486984,2.36458333333333,1.60992907801418,3.09929078014184,141,96
"220",19,5.77,4,260,444,0.0131868131868132,1.70769230769231,1.70769230769231,1.84956095972508,63,48,122,0.4426589012146,2.34234234234234,1.52941176470588,3.28235294117647,170,111
"221",19,6.91,5,267,506,0.0142491059108445,1.89513108614232,1.89513108614232,1.84245828496277,63,48,128,0.430451184511185,2.40540540540541,1.51704545454545,3.23863636363636,176,111
"222",19,7.48,6,273,401,0.0108004740357682,1.46886446886447,1.46886446886447,1.84514275346456,71,53,119,0.50074315071106,2.20161290322581,1.58720930232558,3.15116279069767,172,124
"223",19,10.37,7,296,523,0.011978928080623,1.76689189189189,1.76689189189189,1.88399985095546,71,59,143,0.467944830656052,2.27692307692308,1.46534653465347,3.08910891089109,202,130
"224",19,13.61,8,307,607,0.0129228673011007,1.9771986970684,1.9771986970684,1.8374575585458,76,58,156,0.447146028280258,2.2910447761194,1.43457943925234,3.13551401869159,214,134
"225",19,14.31,9,315,547,0.0110605601051461,1.73650793650794,1.73650793650794,1.71568292386692,81,61,159,0.489286720752716,2.21830985915493,1.43181818181818,3.05,220,142
"226",19,14.44,10,318,661,0.0131142987520584,2.07861635220126,2.07861635220126,1.81039151451767,76,67,165,0.417499959468842,2.22377622377622,1.37068965517241,3.02586206896552,232,143
"227",19,17.92,11,329,648,0.012009785751353,1.96960486322188,1.96960486322188,1.5803022090676,80,66,176,0.455487489700317,2.25342465753425,1.3595041322314,2.81404958677686,242,146
"228",19,21.5,12,349,753,0.0123999604782136,2.15759312320917,2.15759312320917,1.78717874239867,88,78,183,0.424523204565048,2.10240963855422,1.33716475095785,2.88505747126437,261,166
"229",20,2.89,1,163,154,0.0116640157539953,0.94478527607362,0.94478527607362,1.86042748984116,38,14,61,0.516676485538483,3.13461538461538,2.17333333333333,3.94666666666667,75,52
"230",20,3.59,2,200,239,0.0120100502512563,1.195,1.195,2.09006865639028,48,33,68,0.499684870243073,2.46913580246914,1.98019801980198,3.72277227722772,101,81
"231",20,3.72,3,217,290,0.0123741252773511,1.33640552995392,1.33640552995392,1.98004144987315,57,30,91,0.475844264030457,2.49425287356322,1.79338842975207,3.47107438016529,121,87
"232",20,5.24,4,249,418,0.0135380230599819,1.67871485943775,1.67871485943775,1.8094785466286,59,46,117,0.450716555118561,2.37142857142857,1.52760736196319,3.19018404907975,163,105
"233",20,7.46,5,273,503,0.0135477267830209,1.84249084249084,1.84249084249084,1.89795608364405,70,54,131,0.386211514472961,2.20161290322581,1.47567567567568,3.19459459459459,185,124
"234",20,8.24,6,285,453,0.0111934766493699,1.58947368421053,1.58947368421053,1.57990674105445,71,50,138,0.518074214458466,2.35537190082645,1.51595744680851,2.90957446808511,188,121
"235",20,11.48,7,299,567,0.0127269870485511,1.89632107023411,1.89632107023411,1.85407454386468,73,66,146,0.428153067827225,2.15107913669065,1.41037735849057,2.97169811320755,212,139
"236",20,12.62,8,303,559,0.0122177780691976,1.84488448844884,1.84488448844884,1.82452123115021,71,59,143,0.430174976587296,2.33076923076923,1.5,3.12871287128713,202,130
"237",20,13.87,9,315,658,0.0133050247699929,2.08888888888889,2.08888888888889,1.79518961452299,77,66,165,0.439839124679565,2.2027972027972,1.36363636363636,3.00865800865801,231,143
"238",20,17.45,10,337,721,0.0127349159248269,2.13946587537092,2.13946587537092,1.8221508634802,86,75,176,0.4218789935112,2.09316770186335,1.34262948207171,2.93625498007968,251,161
"239",20,18.02,11,340,727,0.0126149574874197,2.13823529411765,2.13823529411765,1.80442951586108,86,74,177,0.439648509025574,2.125,1.35458167330677,2.91633466135458,251,160
"240",20,21.5,12,349,753,0.0123999604782136,2.15759312320917,2.15759312320917,1.78717874239867,88,78,183,0.424523204565048,2.10240963855422,1.33716475095785,2.88505747126437,261,166
"241",21,0.57,1,142,115,0.0114873638997103,0.809859154929577,0.809859154929577,1.71458315989402,33,16,48,0.630775034427643,2.89795918367347,2.21875,3.90625,64,49
"242",21,2.09,2,177,169,0.0108500256805342,0.954802259887006,0.954802259887006,2.21561182042735,42,20,63,0.525576829910278,2.85483870967742,2.13253012048193,3.73493975903614,83,62
"243",21,5.33,3,218,279,0.0117955439056356,1.27981651376147,1.27981651376147,1.62098823877561,53,34,88,0.513020157814026,2.50574712643678,1.78688524590164,3.25409836065574,122,87
"244",21,8.81,4,240,291,0.0101464435146444,1.2125,1.2125,1.50150382212058,61,35,103,0.579480707645416,2.5,1.73913043478261,2.82608695652174,138,96
"245",21,12.39,5,273,476,0.0128205128205128,1.74358974358974,1.74358974358974,1.88687846385777,70,54,127,0.468749940395355,2.20161290322581,1.50828729281768,2.97790055248619,181,124
"246",21,13.17,6,287,493,0.0120123778660364,1.71777003484321,1.71777003484321,1.78209417357375,71,51,147,0.501164376735687,2.35245901639344,1.44949494949495,2.97474747474747,198,122
"247",21,15.39,7,306,600,0.0128576020572163,1.96078431372549,1.96078431372549,1.81044510422433,75,64,159,0.462655544281006,2.20143884892086,1.37219730941704,2.87443946188341,223,139
"248",21,16.53,8,309,617,0.0129659984028916,1.99676375404531,1.99676375404531,1.78049180246434,76,59,153,0.431704163551331,2.28888888888889,1.45754716981132,3.19811320754717,212,135
"249",21,17.78,9,325,631,0.0119848053181387,1.94153846153846,1.94153846153846,1.84509169585995,84,73,164,0.456320434808731,2.07006369426752,1.37130801687764,2.82700421940928,237,157
"250",21,20.67,10,339,700,0.0122183239950429,2.06489675516224,2.06489675516224,1.7952137690966,85,72,177,0.422747939825058,2.15923566878981,1.36144578313253,2.94377510040161,249,157
"251",21,21.37,11,346,742,0.0124319343218564,2.14450867052023,2.14450867052023,1.79581166247963,87,77,182,0.445799201726913,2.10975609756098,1.33590733590734,2.86872586872587,259,164
"252",21,21.5,12,349,753,0.0123999604782136,2.15759312320917,2.15759312320917,1.78717874239867,88,78,183,0.424523204565048,2.10240963855422,1.33716475095785,2.88505747126437,261,166
"253",22,2.22,1,171,196,0.013484692122463,1.14619883040936,1.14619883040936,1.66256853183169,39,26,71,0.538252294063568,2.63076923076923,1.76288659793814,3.52577319587629,97,65
"254",22,3,2,199,246,0.0124866758032587,1.23618090452261,1.23618090452261,1.88394054897535,43,31,76,0.544707119464874,2.68918918918919,1.85981308411215,3.74766355140187,107,74
"255",22,6.58,3,253,358,0.0112303155781417,1.41501976284585,1.41501976284585,1.6510314781172,72,39,109,0.571486592292786,2.27927927927928,1.70945945945946,3.14864864864865,148,111
"256",22,9.47,4,280,492,0.0125960061443932,1.75714285714286,1.75714285714286,1.93503305544164,64,53,124,0.406677603721619,2.39316239316239,1.5819209039548,3.19209039548023,177,117
"257",22,9.6,5,287,494,0.0120367437440608,1.7212543554007,1.7212543554007,1.84990101900114,68,51,141,0.447739243507385,2.41176470588235,1.49479166666667,3.14583333333333,192,119
"258",22,11.12,6,301,534,0.0118272425249169,1.77408637873754,1.77408637873754,1.87814154423995,80,63,136,0.476465463638306,2.1048951048951,1.51256281407035,3.07035175879397,199,143
"259",22,11.82,7,310,611,0.0127570727633365,1.97096774193548,1.97096774193548,1.80773986111922,78,63,158,0.448907256126404,2.19858156028369,1.4027149321267,3.01809954751131,221,141
"260",22,13.07,8,323,612,0.0117685518143184,1.89473684210526,1.89473684210526,1.81650868941647,84,70,159,0.475523591041565,2.0974025974026,1.41048034934498,2.86899563318777,229,154
"261",22,16.31,9,333,675,0.0122110061869098,2.02702702702703,2.02702702702703,1.77642029832616,83,71,172,0.452779203653336,2.16233766233766,1.37037037037037,2.94650205761317,243,154
"262",22,16.88,10,336,705,0.0125266524520256,2.09821428571429,2.09821428571429,1.78738985242287,86,75,172,0.436994075775146,2.08695652173913,1.36032388663968,2.89068825910931,247,161
"263",22,18.02,11,340,722,0.0125281971195558,2.12352941176471,2.12352941176471,1.80179663669848,84,76,176,0.438893228769302,2.125,1.34920634920635,2.89285714285714,252,160
"264",22,21.5,12,349,753,0.0123999604782136,2.15759312320917,2.15759312320917,1.78717874239867,88,78,183,0.424523204565048,2.10240963855422,1.33716475095785,2.88505747126437,261,166
"265",23,1.52,1,120,110,0.015406162464986,0.916666666666667,0.916666666666667,1.99798495614757,24,17,40,0.515413284301758,2.92682926829268,2.10526315789474,4.15789473684211,57,41
"266",23,2.66,2,164,181,0.0135418225347898,1.10365853658537,1.10365853658537,1.66625309184185,39,22,65,0.561017632484436,2.68852459016393,1.88505747126437,3.44827586206897,87,61
"267",23,3.91,3,207,265,0.0124290605506308,1.28019323671498,1.28019323671498,1.94389787168197,56,31,85,0.496674984693527,2.37931034482759,1.78448275862069,3.22413793103448,116,87
"268",23,6.8,4,251,436,0.0138964143426295,1.73705179282869,1.73705179282869,1.61136949743624,55,48,118,0.453697085380554,2.4368932038835,1.51204819277108,3.09036144578313,166,103
"269",23,10.38,5,280,532,0.0136200716845878,1.9,1.9,1.79997363382277,67,52,136,0.430910468101501,2.35294117647059,1.48936170212766,3.26063829787234,188,119
"270",23,10.95,6,290,536,0.0127908364157022,1.84827586206897,1.84827586206897,1.84463413958867,79,53,141,0.467479526996613,2.1969696969697,1.49484536082474,3.0360824742268,194,132
"271",23,14.19,7,307,584,0.0124332034659684,1.90228013029316,1.90228013029316,1.62196006292008,77,62,156,0.477368801832199,2.20863309352518,1.40825688073395,2.8348623853211,218,139
"272",23,14.89,8,316,611,0.0122764717701427,1.93354430379747,1.93354430379747,1.58206818033169,82,62,166,0.451839029788971,2.19444444444444,1.3859649122807,2.8640350877193,228,144
"273",23,17.11,9,329,643,0.0119171176514197,1.95440729483283,1.95440729483283,1.85611390708087,86,72,160,0.413188755512238,2.08227848101266,1.41810344827586,2.98706896551724,232,158
"274",23,17.24,10,333,675,0.0122110061869098,2.02702702702703,2.02702702702703,1.78916716469972,86,72,169,0.403277933597565,2.10759493670886,1.38174273858921,2.94605809128631,241,158
"275",23,20.72,11,342,734,0.0125876764246883,2.14619883040936,2.14619883040936,1.78501327384802,85,76,178,0.414527177810669,2.12422360248447,1.34645669291339,2.91732283464567,254,161
"276",23,21.5,12,349,753,0.0123999604782136,2.15759312320917,2.15759312320917,1.78717874239867,88,78,183,0.424523204565048,2.10240963855422,1.33716475095785,2.88505747126437,261,166
"277",24,3.24,1,156,115,0.00951199338296112,0.737179487179487,0.737179487179487,1.56469930649668,27,16,56,0.608015120029449,3.62790697674419,2.16666666666667,3.68055555555556,72,43
"278",24,5.46,2,206,313,0.0148235851290552,1.51941747572816,1.51941747572816,1.8152139760399,53,28,96,0.458384782075882,2.54320987654321,1.66129032258065,3.60483870967742,124,81
"279",24,5.59,3,222,245,0.0099873629285394,1.1036036036036,1.1036036036036,1.933850552209,47,31,85,0.502965450286865,2.84615384615385,1.91379310344828,3.9051724137931,116,78
"280",24,6.84,4,250,399,0.0128192771084337,1.596,1.596,1.61593283293094,65,40,113,0.430248498916626,2.38095238095238,1.63398692810458,3.35294117647059,153,105
"281",24,9.73,5,276,409,0.0107773386034256,1.48188405797101,1.48188405797101,1.9789129145814,68,49,115,0.47197225689888,2.35897435897436,1.68292682926829,3.1890243902439,164,117
"282",24,11.25,6,295,469,0.0108151735270379,1.58983050847458,1.58983050847458,1.79615162357933,72,55,135,0.473911315202713,2.32283464566929,1.55263157894737,3.16315789473684,190,127
"283",24,12.39,7,299,618,0.0138717424973626,2.06688963210702,2.06688963210702,1.91500894736572,74,68,150,0.367634683847427,2.1056338028169,1.37155963302752,3.02293577981651,218,142
"284",24,15.97,8,322,657,0.0127126023103268,2.04037267080745,2.04037267080745,1.84001807751029,81,68,162,0.40935805439949,2.16107382550336,1.4,3.01739130434783,230,149
"285",24,16.75,9,331,689,0.0126155817998718,2.08157099697885,2.08157099697885,1.79299670757303,84,71,171,0.425698459148407,2.13548387096774,1.36776859504132,2.96280991735537,242,155
"286",24,17.32,10,334,700,0.0125874377371383,2.09580838323353,2.09580838323353,1.819995225091,83,73,168,0.438240826129913,2.14102564102564,1.38589211618257,3.0207468879668,241,156
"287",24,18.02,11,340,712,0.0123546763838279,2.09411764705882,2.09411764705882,1.76496425055049,79,75,177,0.427655726671219,2.20779220779221,1.34920634920635,2.8968253968254,252,154
"288",24,21.5,12,349,753,0.0123999604782136,2.15759312320917,2.15759312320917,1.78717874239867,88,78,183,0.424523204565048,2.10240963855422,1.33716475095785,2.88505747126437,261,166
"289",25,0.57,1,142,160,0.0159824193387274,1.12676056338028,1.12676056338028,2.0327875386535,30,15,49,0.454492151737213,3.15555555555556,2.21875,4.875,64,45
"290",25,1.82,2,186,231,0.0134263295553618,1.24193548387097,1.24193548387097,2.0930987533922,45,21,76,0.475468993186951,2.81818181818182,1.91752577319588,3.7319587628866,97,66
"291",25,4.04,3,236,269,0.00970068517850703,1.13983050847458,1.13983050847458,1.75500668618895,56,39,88,0.517281353473663,2.48421052631579,1.85826771653543,3.26771653543307,127,95
"292",25,5.18,4,241,317,0.0109612724757953,1.31535269709544,1.31535269709544,1.8892138688662,63,39,101,0.516260504722595,2.36274509803922,1.72142857142857,3.37857142857143,140,102
"293",25,8.07,5,268,518,0.0144781709430376,1.93283582089552,1.93283582089552,1.85944289204854,70,55,126,0.447237282991409,2.144,1.48066298342541,3.40883977900552,181,125
"294",25,11.55,6,283,490,0.0122797784627722,1.73144876325088,1.73144876325088,1.56083214173236,75,48,137,0.494235783815384,2.30081300813008,1.52972972972973,2.99459459459459,185,123
"295",25,12.25,7,292,513,0.0120745657393024,1.75684931506849,1.75684931506849,1.59595989456251,73,61,143,0.476834267377853,2.17910447761194,1.43137254901961,2.78921568627451,204,134
"296",25,13.03,8,302,606,0.0133330399771182,2.00662251655629,2.00662251655629,1.81214057406678,70,58,152,0.410489410161972,2.359375,1.43809523809524,3.16190476190476,210,128
"297",25,16.61,9,328,684,0.0127545312150369,2.08536585365854,2.08536585365854,1.80666727398357,82,70,169,0.422580868005753,2.15789473684211,1.37238493723849,2.93305439330544,239,152
"298",25,19.85,10,338,703,0.0123435113163486,2.07988165680473,2.07988165680473,1.82224569299618,86,75,175,0.423321902751923,2.09937888198758,1.352,2.828,250,161
"299",25,19.98,11,341,707,0.01219596342936,2.0733137829912,2.0733137829912,1.76309155274313,88,75,177,0.453455924987793,2.0920245398773,1.3531746031746,2.82539682539683,252,163
"300",25,21.5,12,349,753,0.0123999604782136,2.15759312320917,2.15759312320917,1.78717874239867,88,78,183,0.424523204565048,2.10240963855422,1.33716475095785,2.88505747126437,261,166
"301",26,3.58,1,171,146,0.0100447196422429,0.853801169590643,0.853801169590643,2.16215804756464,36,18,65,0.590823769569397,3.16666666666667,2.06024096385542,3.24096385542169,83,54
"302",26,4.15,2,212,284,0.0126978449432174,1.33962264150943,1.33962264150943,1.56679439659361,59,27,92,0.542141914367676,2.46511627906977,1.78151260504202,3.42016806722689,119,86
"303",26,7.04,3,255,378,0.0116720704029643,1.48235294117647,1.48235294117647,1.56424400946792,58,41,122,0.45455402135849,2.57575757575758,1.56441717791411,3.09815950920245,163,99
"304",26,10.52,4,270,435,0.0119785212722016,1.61111111111111,1.61111111111111,1.57686340382024,69,46,129,0.4828220307827,2.34782608695652,1.54285714285714,3.05142857142857,175,115
"305",26,11.77,5,285,472,0.011662960217445,1.65614035087719,1.65614035087719,1.90818249800408,79,49,135,0.508721470832825,2.2265625,1.54891304347826,3.13586956521739,184,128
"306",26,12.91,6,290,538,0.0128385634172533,1.8551724137931,1.8551724137931,1.95458188736549,82,52,139,0.425356894731522,2.16417910447761,1.51832460732984,3.15706806282722,191,134
"307",26,13.04,7,299,624,0.0140064196089875,2.08695652173913,2.08695652173913,1.82392369915194,74,69,143,0.415238738059998,2.09090909090909,1.41037735849057,3.17924528301887,212,143
"308",26,14.56,8,310,620,0.0129449838187702,2,2,1.87428519276517,79,58,154,0.430001258850098,2.26277372262774,1.4622641509434,3.18396226415094,212,137
"309",26,15.34,9,319,663,0.0130715088424913,2.07836990595611,2.07836990595611,1.83374731779809,77,64,170,0.421508371829987,2.26241134751773,1.36324786324786,2.97008547008547,234,141
"310",26,16.04,10,325,639,0.0121367521367521,1.96615384615385,1.96615384615385,1.78317863610568,82,71,164,0.481168031692505,2.12418300653595,1.38297872340426,2.93191489361702,235,153
"311",26,19.28,11,338,686,0.0120450195775464,2.02958579881657,2.02958579881657,1.80000236723601,82,71,168,0.398511707782745,2.20915032679739,1.41422594142259,3.01673640167364,239,153
"312",26,21.5,12,349,753,0.0123999604782136,2.15759312320917,2.15759312320917,1.78717874239867,88,78,183,0.424523204565048,2.10240963855422,1.33716475095785,2.88505747126437,261,166
"313",27,1.14,1,114,76,0.0117994100294985,0.666666666666667,0.666666666666667,2.04160270202612,18,4,38,0.514369904994965,5.18181818181818,2.71428571428571,3.95238095238095,42,22
"314",27,1.92,2,164,172,0.0128684722430046,1.04878048780488,1.04878048780488,2.0200463899392,39,22,56,0.500287294387817,2.68852459016393,2.1025641025641,4.30769230769231,78,61
"315",27,5.4,3,200,236,0.0118592964824121,1.18,1.18,1.76942110242937,55,23,81,0.541053235530853,2.56410256410256,1.92307692307692,3.32692307692308,104,78
"316",27,5.97,4,218,268,0.0113304866190335,1.22935779816514,1.22935779816514,1.63110733926279,54,34,97,0.556889057159424,2.47727272727273,1.66412213740458,2.93129770992366,131,88
"317",27,9.55,5,261,412,0.0121426466254052,1.57854406130268,1.57854406130268,1.84846017942294,57,56,112,0.457335770130157,2.30973451327434,1.55357142857143,3.125,168,113
"318",27,10.25,6,273,494,0.0133053221288515,1.80952380952381,1.80952380952381,1.52530292271044,65,53,140,0.415899693965912,2.3135593220339,1.41450777202073,2.93264248704663,193,118
"319",27,10.38,7,278,482,0.0125185050515544,1.73381294964029,1.73381294964029,1.78404402899191,61,55,128,0.445055156946182,2.39655172413793,1.51912568306011,3.28415300546448,183,116
"320",27,11.9,8,291,531,0.0125844294347672,1.82474226804124,1.82474226804124,1.89460039454108,75,56,146,0.446294009685516,2.22137404580153,1.44059405940594,2.93069306930693,202,131
"321",27,13.15,9,306,598,0.0128147433836923,1.95424836601307,1.95424836601307,1.85758522316884,77,66,148,0.414223551750183,2.13986013986014,1.42990654205607,3.11682242990654,214,143
"322",27,15.37,10,327,655,0.0122887000243898,2.00305810397554,2.00305810397554,1.79853547466965,85,69,167,0.421329736709595,2.12337662337662,1.38559322033898,2.86864406779661,236,154
"323",27,18.26,11,340,737,0.0127884782231477,2.16764705882353,2.16764705882353,1.80149683117003,87,76,175,0.405918776988983,2.08588957055215,1.35458167330677,2.94422310756972,251,163
"324",27,21.5,12,349,753,0.0123999604782136,2.15759312320917,2.15759312320917,1.78717874239867,88,78,183,0.424523204565048,2.10240963855422,1.33716475095785,2.88505747126437,261,166
"325",28,3.24,1,156,140,0.0115798180314309,0.897435897435897,0.897435897435897,1.75924455628591,38,19,54,0.60096937417984,2.73684210526316,2.13698630136986,3.24657534246575,73,57
"326",28,6.72,2,198,224,0.0114854125006409,1.13131313131313,1.13131313131313,1.62108258456678,46,27,86,0.533701419830322,2.71232876712329,1.75221238938053,3.07079646017699,113,73
"327",28,10.3,3,248,377,0.0123089983022071,1.52016129032258,1.52016129032258,1.58386468742981,59,41,123,0.478375256061554,2.48,1.51219512195122,2.99390243902439,164,100
"328",28,11,4,266,460,0.0130514966661938,1.72932330827068,1.72932330827068,1.89454400856574,66,49,129,0.428211212158203,2.31304347826087,1.49438202247191,3.03932584269663,178,115
"329",28,12.52,5,280,523,0.013389656938044,1.86785714285714,1.86785714285714,1.8250222414347,71,61,135,0.43653878569603,2.12121212121212,1.42857142857143,2.93367346938776,196,132
"330",28,13.66,6,284,487,0.0121186482854726,1.71478873239437,1.71478873239437,1.83428687060733,73,55,137,0.438575446605682,2.21875,1.47916666666667,3.078125,192,128
"331",28,14.91,7,300,504,0.0112374581939799,1.68,1.68,1.58321193704947,76,59,153,0.470958530902863,2.22222222222222,1.41509433962264,2.59905660377358,212,135
"332",28,15.04,8,304,567,0.0123110995310057,1.86513157894737,1.86513157894737,1.82936724704043,77,62,153,0.43409726023674,2.18705035971223,1.41395348837209,2.91627906976744,215,139
"333",28,15.61,9,312,621,0.0127999010635667,1.99038461538462,1.99038461538462,1.80564411120667,82,66,152,0.432645887136459,2.10810810810811,1.43119266055046,3.15137614678899,218,148
"334",28,17.83,10,329,655,0.0121395210912595,1.99088145896657,1.99088145896657,1.82351323507006,84,68,165,0.431652039289474,2.16447368421053,1.41201716738197,3,233,152
"335",28,20.72,11,342,712,0.0122103891204061,2.08187134502924,2.08187134502924,1.80359052971138,88,75,173,0.439428180456161,2.09815950920245,1.37903225806452,2.93145161290323,248,163
"336",28,21.5,12,349,753,0.0123999604782136,2.15759312320917,2.15759312320917,1.78717874239867,88,78,183,0.424523204565048,2.10240963855422,1.33716475095785,2.88505747126437,261,166
"337",29,0.57,1,142,128,0.0127859354709819,0.901408450704225,0.901408450704225,1.72426380245628,27,16,49,0.546112060546875,3.30232558139535,2.18461538461538,3.63076923076923,65,43
"338",29,4.05,2,185,184,0.0108108108108108,0.994594594594595,0.994594594594595,1.64241668904179,37,23,65,0.544246196746826,3.08333333333333,2.10227272727273,4.39772727272727,88,60
"339",29,6.94,3,229,394,0.0150923159426952,1.72052401746725,1.72052401746725,2.02518073129812,53,47,98,0.412610441446304,2.29,1.57931034482759,3.22758620689655,145,100
"340",29,8.46,4,249,414,0.0134084726000777,1.66265060240964,1.66265060240964,1.82111000107287,60,46,121,0.511665940284729,2.34905660377358,1.49101796407186,3.1497005988024,167,106
"341",29,9.16,5,266,501,0.0142147822386154,1.88345864661654,1.88345864661654,1.60425597224312,70,51,127,0.486179322004318,2.19834710743802,1.49438202247191,3.08426966292135,178,121
"342",29,11.38,6,287,491,0.0119636461099876,1.71080139372822,1.71080139372822,1.7055582642354,67,55,144,0.480574995279312,2.35245901639344,1.44221105527638,3.05025125628141,199,122
"343",29,14.62,7,302,519,0.0114188906734725,1.71854304635762,1.71854304635762,1.87853317191297,75,61,141,0.473793506622314,2.22058823529412,1.4950495049505,2.99009900990099,202,136
"344",29,15.87,8,314,613,0.0124743086221282,1.95222929936306,1.95222929936306,1.78767923694314,83,66,159,0.468356877565384,2.10738255033557,1.39555555555556,2.97777777777778,225,149
"345",29,16.65,9,323,643,0.0123646712689653,1.99071207430341,1.99071207430341,1.82604709368357,85,68,161,0.434510618448257,2.11111111111111,1.41048034934498,2.9825327510917,229,153
"346",29,20.23,10,343,714,0.0121732903687791,2.08163265306122,2.08163265306122,1.80639686865229,86,76,178,0.454064965248108,2.11728395061728,1.3503937007874,2.90944881889764,254,162
"347",29,21.37,11,346,739,0.0123816704364581,2.13583815028902,2.13583815028902,1.78144799130374,88,77,179,0.416966199874878,2.0969696969697,1.3515625,2.921875,256,165
"348",29,21.5,12,349,753,0.0123999604782136,2.15759312320917,2.15759312320917,1.78717874239867,88,78,183,0.424523204565048,2.10240963855422,1.33716475095785,2.88505747126437,261,166
"349",30,0.7,1,144,128,0.0124320124320124,0.888888888888889,0.888888888888889,1.82960789104251,27,15,49,0.481475830078125,3.42857142857143,2.25,4.015625,64,42
"350",30,4.28,2,213,286,0.0126671981574984,1.34272300469484,1.34272300469484,1.62394703392967,49,36,99,0.499633222818375,2.50588235294118,1.57777777777778,2.83703703703704,135,85
"351",30,5.06,3,238,327,0.0115945112222104,1.37394957983193,1.37394957983193,1.97760304301714,60,38,107,0.477106302976608,2.42857142857143,1.64137931034483,3.07586206896552,145,98
"352",30,8.3,4,264,497,0.0143161654568499,1.88257575757576,1.88257575757576,1.81110213606425,72,45,132,0.429607808589935,2.25641025641026,1.49152542372881,3.43502824858757,177,117
"353",30,9.44,5,271,415,0.011343446767801,1.53136531365314,1.53136531365314,1.61403625603989,69,43,124,0.486526370048523,2.41964285714286,1.62275449101796,3.19760479041916,167,112
"354",30,10.96,6,286,507,0.0124401913875598,1.77272727272727,1.77272727272727,1.97915361527055,75,47,125,0.408610790967941,2.34426229508197,1.66279069767442,3.59883720930233,172,122
"355",30,13.18,7,305,572,0.0123382226056946,1.87540983606557,1.87540983606557,1.87756675868718,76,52,151,0.431323081254959,2.3828125,1.50246305418719,3.12807881773399,203,128
"356",30,14.43,8,321,656,0.0127725856697819,2.04361370716511,2.04361370716511,1.84015405015014,84,67,161,0.44164913892746,2.12582781456954,1.40789473684211,3.02631578947368,228,151
"357",30,17.91,9,330,675,0.0124343741365018,2.04545454545455,2.04545454545455,1.85886421955013,84,69,170,0.414299011230469,2.15686274509804,1.38075313807531,2.94142259414226,239,153
"358",30,18.04,10,333,682,0.0123376388436629,2.04804804804805,2.04804804804805,1.83619715284615,83,73,164,0.428112715482712,2.13461538461538,1.40506329113924,3.0042194092827,237,156
"359",30,20.93,11,346,747,0.012515707464187,2.15895953757225,2.15895953757225,1.79343651097475,88,77,181,0.421833723783493,2.0969696969697,1.34108527131783,2.89922480620155,258,165
"360",30,21.5,12,349,753,0.0123999604782136,2.15759312320917,2.15759312320917,1.78717874239867,88,78,183,0.424523204565048,2.10240963855422,1.33716475095785,2.88505747126437,261,166
"361",31,2.89,1,163,192,0.0145421495114747,1.17791411042945,1.17791411042945,1.84344509275223,37,19,67,0.493204742670059,2.91071428571429,1.8953488372093,4.01162790697674,86,56
"362",31,3.59,2,200,197,0.00989949748743719,0.985,0.985,1.46954139599289,51,19,86,0.586539149284363,2.85714285714286,1.9047619047619,3.00952380952381,105,70
"363",31,7.17,3,247,423,0.0139231756690037,1.71255060728745,1.71255060728745,1.84449978661844,69,42,114,0.474705010652542,2.22522522522523,1.58333333333333,3.32692307692308,156,111
"364",31,10.65,4,267,424,0.0119399622652136,1.58801498127341,1.58801498127341,1.79805299849834,72,47,128,0.47498545050621,2.2436974789916,1.52571428571429,3.10857142857143,175,119
"365",31,12.87,5,294,515,0.0119570012305263,1.75170068027211,1.75170068027211,1.84754842682235,66,54,139,0.443704426288605,2.45,1.52331606217617,3.18134715025907,193,120
"366",31,13,6,298,602,0.0136035974962149,2.02013422818792,2.02013422818792,1.77945577250174,73,62,143,0.39259085059166,2.20740740740741,1.45365853658537,3.28292682926829,205,135
"367",31,14.14,7,304,549,0.0119202709744659,1.80592105263158,1.80592105263158,1.46246715256678,74,60,160,0.476534634828568,2.26865671641791,1.38181818181818,2.68636363636364,220,134
"368",31,17.38,8,317,605,0.0120792237351755,1.90851735015773,1.90851735015773,1.83230769286107,83,61,162,0.49488964676857,2.20138888888889,1.42152466367713,2.94618834080717,223,144
"369",31,18.16,9,326,651,0.0122888154789995,1.99693251533742,1.99693251533742,1.8431858277105,83,69,169,0.416231840848923,2.14473684210526,1.36974789915966,2.84873949579832,238,152
"370",31,19.68,10,335,673,0.012029671999285,2.0089552238806,2.0089552238806,1.80154122511483,80,73,171,0.390486091375351,2.18954248366013,1.37295081967213,2.90163934426229,244,153
"371",31,20.25,11,339,708,0.0123579619835576,2.08849557522124,2.08849557522124,1.78308298766628,85,72,175,0.435542941093445,2.15923566878981,1.37246963562753,2.97975708502024,247,157
"372",31,21.5,12,349,753,0.0123999604782136,2.15759312320917,2.15759312320917,1.78717874239867,88,78,183,0.424523204565048,2.10240963855422,1.33716475095785,2.88505747126437,261,166
"373",32,3.24,1,156,144,0.0119106699751861,0.923076923076923,0.923076923076923,1.9517017663942,33,23,55,0.539785861968994,2.78571428571429,2,3.69230769230769,78,56
"374",32,4.76,2,196,230,0.0120355834641549,1.1734693877551,1.1734693877551,2.02775525690381,38,29,69,0.486323237419128,2.92537313432836,2,3.92857142857143,98,67
"375",32,6.98,3,232,331,0.0123525899387968,1.42672413793103,1.42672413793103,1.82538488583638,53,36,106,0.526063084602356,2.60674157303371,1.63380281690141,3.1830985915493,142,89
"376",32,8.23,4,263,493,0.0143093489681595,1.8745247148289,1.8745247148289,1.89295408944958,60,44,127,0.422085702419281,2.52884615384615,1.53801169590643,3.3625730994152,171,104
"377",32,8.36,5,272,520,0.014108964619058,1.91176470588235,1.91176470588235,1.91701092685661,66,51,131,0.438851714134216,2.32478632478632,1.49450549450549,3.28571428571429,182,117
"378",32,9.06,6,282,461,0.0116352439362964,1.63475177304965,1.63475177304965,1.85332950282483,68,49,131,0.454439789056778,2.41025641025641,1.56666666666667,3.24444444444444,180,117
"379",32,10.2,7,286,504,0.0123665807876334,1.76223776223776,1.76223776223776,1.82500661745336,69,55,138,0.446676552295685,2.30645161290323,1.48186528497409,3.04663212435233,193,124
"380",32,13.68,8,299,574,0.0128841103454468,1.91973244147157,1.91973244147157,1.60641120413851,81,54,154,0.430129915475845,2.21481481481481,1.4375,3.04326923076923,208,135
"381",32,14.46,9,310,617,0.0128823468002923,1.99032258064516,1.99032258064516,1.79066982155516,79,68,158,0.455541163682938,2.10884353741497,1.3716814159292,2.91150442477876,226,147
"382",32,17.35,10,326,699,0.013194903256253,2.1441717791411,2.1441717791411,1.77737900083231,83,72,166,0.42068275809288,2.10322580645161,1.36974789915966,3.04201680672269,238,155
"383",32,20.93,11,346,745,0.0124821982072548,2.15317919075145,2.15317919075145,1.7969684806156,88,78,180,0.421162992715836,2.08433734939759,1.34108527131783,2.88759689922481,258,166
"384",32,21.5,12,349,753,0.0123999604782136,2.15759312320917,2.15759312320917,1.78717874239867,88,78,183,0.424523204565048,2.10240963855422,1.33716475095785,2.88505747126437,261,166
"385",33,3.58,1,171,217,0.0149294805641555,1.26900584795322,1.26900584795322,1.77407201760821,45,22,68,0.5041623711586,2.55223880597015,1.9,3.43333333333333,90,67
"386",33,6.47,2,229,351,0.0134451850149391,1.53275109170306,1.53275109170306,1.74817884850884,53,33,101,0.429286301136017,2.66279069767442,1.7089552238806,3.70149253731343,134,86
"387",33,7.72,3,249,351,0.0113680528565876,1.40963855421687,1.40963855421687,1.59406550883662,61,45,109,0.54786491394043,2.34905660377358,1.61688311688312,2.94805194805195,154,106
"388",33,7.85,4,263,402,0.0116680695440165,1.52851711026616,1.52851711026616,1.65445876399146,63,44,120,0.478351444005966,2.45794392523365,1.60365853658537,3.10365853658537,164,107
"389",33,9.37,5,282,539,0.0136038969233487,1.9113475177305,1.9113475177305,1.82811642827154,75,51,143,0.452715963125229,2.23809523809524,1.45360824742268,3.01546391752577,194,126
"390",33,9.94,6,294,523,0.0121427410554666,1.77891156462585,1.77891156462585,1.94416388839434,75,60,139,0.431122481822968,2.17777777777778,1.47738693467337,3.00502512562814,199,135
"391",33,10.72,7,303,610,0.0133324590737219,2.01320132013201,2.01320132013201,1.8426562833235,75,63,149,0.424360394477844,2.19565217391304,1.42924528301887,3.11792452830189,212,138
"392",33,13.96,8,317,594,0.011859601485445,1.87381703470032,1.87381703470032,1.79499988388774,83,58,160,0.46343058347702,2.24822695035461,1.45412844036697,3.11009174311927,218,141
"393",33,15.1,9,322,598,0.0115709835336004,1.85714285714286,1.85714285714286,1.57817190297135,81,62,169,0.496793955564499,2.25174825174825,1.39393939393939,2.6969696969697,231,143
"394",33,17.32,10,334,713,0.0128212044379709,2.13473053892216,2.13473053892216,1.82945292359767,87,70,173,0.414120465517044,2.12738853503185,1.37448559670782,3,243,157
"395",33,20.8,11,343,744,0.0126847731573833,2.16909620991254,2.16909620991254,1.79112223745447,86,77,180,0.413908064365387,2.10429447852761,1.33463035019455,2.90661478599222,257,163
"396",33,21.5,12,349,753,0.0123999604782136,2.15759312320917,2.15759312320917,1.78717874239867,88,78,183,0.424523204565048,2.10240963855422,1.33716475095785,2.88505747126437,261,166
"397",34,0.78,1,137,96,0.0103048518677544,0.700729927007299,0.700729927007299,1.75093710320476,29,13,40,0.650010824203491,3.26190476190476,2.58490566037736,4,53,42
"398",34,4.26,2,185,211,0.0123971797884841,1.14054054054054,1.14054054054054,2.00722839081879,41,17,74,0.526111245155334,3.18965517241379,2.03296703296703,3.81318681318681,91,58
"399",34,7.15,3,230,408,0.0154926903360547,1.77391304347826,1.77391304347826,1.87161084568267,58,39,104,0.40637618303299,2.37113402061856,1.60839160839161,3.78321678321678,143,97
"400",34,8.4,4,254,428,0.0133204693286857,1.68503937007874,1.68503937007874,1.84330017594924,63,48,120,0.48415794968605,2.28828828828829,1.51190476190476,3.31547619047619,168,111
"401",34,9.1,5,268,404,0.0112918553300911,1.50746268656716,1.50746268656716,1.85729489020938,67,45,123,0.512624382972717,2.39285714285714,1.5952380952381,3.18452380952381,168,112
"402",34,9.67,6,277,468,0.0122429759849317,1.68953068592058,1.68953068592058,1.88900428630376,66,51,132,0.435975074768066,2.36752136752137,1.51366120218579,3.08196721311475,183,117
"403",34,10.81,7,281,497,0.0126334519572954,1.76868327402135,1.76868327402135,1.92149179257801,72,56,130,0.439271420240402,2.1953125,1.51075268817204,3.09677419354839,186,128
"404",34,13.03,8,302,582,0.0128049987899056,1.92715231788079,1.92715231788079,1.87698359055236,80,64,150,0.464338213205338,2.09722222222222,1.41121495327103,2.91121495327103,214,144
"405",34,16.27,9,314,582,0.0118434708288395,1.85350318471338,1.85350318471338,1.88659440846343,80,64,154,0.447677135467529,2.18055555555556,1.44036697247706,2.89449541284404,218,144
"406",34,16.4,10,317,639,0.0127580561434333,2.01577287066246,2.01577287066246,1.80878574642748,81,67,159,0.428134977817535,2.14189189189189,1.40265486725664,2.94690265486726,226,148
"407",34,17.92,11,329,652,0.0120839202312996,1.98176291793313,1.98176291793313,1.84266054722606,84,70,165,0.444849967956543,2.13636363636364,1.4,2.91063829787234,235,154
"408",34,21.5,12,349,753,0.0123999604782136,2.15759312320917,2.15759312320917,1.78717874239867,88,78,183,0.424523204565048,2.10240963855422,1.33716475095785,2.88505747126437,261,166
"409",35,2.22,1,171,205,0.0141038871689026,1.19883040935673,1.19883040935673,2.09587880898289,43,23,61,0.481249243021011,2.59090909090909,2.03571428571429,4.33333333333333,84,66
"410",35,2.79,2,204,273,0.013184584178499,1.33823529411765,1.33823529411765,1.92106041471566,53,29,86,0.547954440116882,2.48780487804878,1.77391304347826,3.39130434782609,115,82
"411",35,3.57,3,223,376,0.015190077970347,1.68609865470852,1.68609865470852,1.92223866786455,63,31,105,0.441977441310883,2.37234042553191,1.63970588235294,3.44852941176471,136,94
"412",35,6.46,4,254,398,0.0123867915720021,1.56692913385827,1.56692913385827,1.62700589690276,54,44,114,0.435869634151459,2.59183673469388,1.60759493670886,3.18987341772152,158,98
"413",35,9.7,5,274,474,0.0126734579289324,1.72992700729927,1.72992700729927,1.82396621678046,70,49,131,0.413032531738281,2.30252100840336,1.52222222222222,3.25555555555556,180,119
"414",35,10.4,6,286,524,0.012857318120476,1.83216783216783,1.83216783216783,1.80123036107162,72,56,140,0.449134290218353,2.234375,1.45918367346939,3.25,196,128
"415",35,11.54,7,290,510,0.0121703853955375,1.75862068965517,1.75862068965517,1.9107079980169,75,57,137,0.430219203233719,2.1969696969697,1.49484536082474,3.11340206185567,194,132
"416",35,12.79,8,302,578,0.0127169919253702,1.91390728476821,1.91390728476821,1.76987271619216,79,62,149,0.451031863689423,2.14184397163121,1.43127962085308,3.18483412322275,211,141
"417",35,12.92,9,305,582,0.0125539257981018,1.90819672131148,1.90819672131148,1.80575715829283,79,61,150,0.430763721466064,2.17857142857143,1.44549763033175,3.05687203791469,211,140
"418",35,16.5,10,332,665,0.0121027918319805,2.00301204819277,2.00301204819277,1.79922721641192,85,70,163,0.446702480316162,2.14193548387097,1.42489270386266,3.07725321888412,233,155
"419",35,18.02,11,340,723,0.0125455491931286,2.12647058823529,2.12647058823529,1.78962539846622,84,75,177,0.441933572292328,2.13836477987421,1.34920634920635,2.92857142857143,252,159
"420",35,21.5,12,349,753,0.0123999604782136,2.15759312320917,2.15759312320917,1.78717874239867,88,78,183,0.424523204565048,2.10240963855422,1.33716475095785,2.88505747126437,261,166
"421",36,3.58,1,171,172,0.0118335053319573,1.00584795321637,1.00584795321637,2.07002325153375,39,20,58,0.515278577804565,2.89830508474576,2.19230769230769,4.02564102564103,78,59
"422",36,5.1,2,202,234,0.011526525786907,1.15841584158416,1.15841584158416,1.69936587100683,48,19,93,0.492722243070602,3.01492537313433,1.80357142857143,3.21428571428571,112,67
"423",36,6.35,3,237,376,0.0134448973753844,1.58649789029536,1.58649789029536,1.89339382051766,53,36,113,0.477167278528214,2.66292134831461,1.59060402684564,3.29530201342282,149,89
"424",36,6.92,4,255,360,0.0111162575266327,1.41176470588235,1.41176470588235,1.59492064763924,61,36,117,0.484008431434631,2.62886597938144,1.66666666666667,3.06535947712418,153,97
"425",36,7.05,5,266,375,0.0106398070648319,1.40977443609023,1.40977443609023,1.65141125848593,63,44,122,0.495921790599823,2.48598130841122,1.60240963855422,2.98192771084337,166,107
"426",36,10.53,6,280,529,0.0135432667690732,1.88928571428571,1.88928571428571,1.71690521412855,70,54,139,0.456437736749649,2.25806451612903,1.45077720207254,3.26943005181347,193,124
"427",36,13.42,7,305,638,0.0137618636755824,2.09180327868852,2.09180327868852,1.83834900686516,78,61,156,0.391751229763031,2.19424460431655,1.40552995391705,3.10599078341014,217,139
"428",36,14.2,8,314,600,0.0122097637410716,1.91082802547771,1.91082802547771,1.81420744921759,80,58,154,0.452706933021545,2.27536231884058,1.4811320754717,3.16981132075472,212,138
"429",36,14.9,9,321,613,0.0119353582554517,1.90965732087227,1.90965732087227,1.74375165940993,80,64,164,0.452118158340454,2.22916666666667,1.40789473684211,3.09210526315789,228,144
"430",36,17.12,10,336,707,0.0125621890547264,2.10416666666667,2.10416666666667,1.78980683426874,86,76,170,0.422775626182556,2.07407407407407,1.36585365853659,2.88211382113821,246,162
"431",36,18.26,11,340,730,0.0126670137081381,2.14705882352941,2.14705882352941,1.79668359025235,85,76,177,0.439165890216827,2.11180124223602,1.34387351778656,2.91699604743083,253,161
"432",36,21.5,12,349,753,0.0123999604782136,2.15759312320917,2.15759312320917,1.78717874239867,88,78,183,0.424523204565048,2.10240963855422,1.33716475095785,2.88505747126437,261,166
"433",37,0.13,1,110,47,0.00783986655546288,0.427272727272727,0.427272727272727,2.54529816370497,19,9,23,0.724536001682281,3.92857142857143,3.4375,4.40625,32,28
"434",37,0.83,2,171,171,0.0117647058823529,1,1,1.68383316205824,40,17,67,0.539875507354736,3,2.03571428571429,3.58333333333333,84,57
"435",37,1.97,3,185,252,0.0148061104582844,1.36216216216216,1.36216216216216,2.21083321740411,51,27,66,0.434193104505539,2.37179487179487,1.98924731182796,4.03225806451613,93,78
"436",37,3.22,4,211,296,0.0133604152561499,1.40284360189573,1.40284360189573,2.15808823283234,49,36,81,0.411996692419052,2.48235294117647,1.8034188034188,3.64102564102564,117,85
"437",37,6.11,5,246,333,0.0110502737680438,1.35365853658537,1.35365853658537,2.00360978728473,63,40,99,0.44951257109642,2.38834951456311,1.76978417266187,3.42446043165468,139,103
"438",37,6.89,6,266,425,0.0120584480068095,1.59774436090226,1.59774436090226,1.77691310245134,67,49,125,0.468404144048691,2.29310344827586,1.52873563218391,3.05747126436782,174,116
"439",37,10.47,7,298,469,0.0105981515377489,1.5738255033557,1.5738255033557,1.85847583487745,68,52,143,0.459686040878296,2.48333333333333,1.52820512820513,2.93846153846154,195,120
"440",37,11.99,8,312,604,0.0124495011954819,1.93589743589744,1.93589743589744,1.78621643441904,77,62,155,0.444308876991272,2.24460431654676,1.43778801843318,3.03225806451613,217,139
"441",37,15.23,9,325,658,0.0124976258309592,2.02461538461538,2.02461538461538,1.84885762912936,86,66,166,0.447999149560928,2.13815789473684,1.40086206896552,2.98706896551724,232,152
"442",37,15.8,10,328,655,0.0122137689266801,1.9969512195122,1.9969512195122,1.75119377152531,81,71,172,0.444616317749023,2.1578947368421,1.34979423868313,2.90534979423868,243,152
"443",37,19.28,11,338,709,0.0124488613418082,2.09763313609467,2.09763313609467,1.81667672249483,86,75,170,0.42572033405304,2.09937888198758,1.37959183673469,2.97142857142857,245,161
"444",37,21.5,12,349,753,0.0123999604782136,2.15759312320917,2.15759312320917,1.78717874239867,88,78,183,0.424523204565048,2.10240963855422,1.33716475095785,2.88505747126437,261,166
"445",38,1.52,1,120,108,0.0151260504201681,0.9,0.9,1.56074896697006,28,18,35,0.547453701496124,2.60869565217391,2.26415094339623,3.83018867924528,53,46
"446",38,2.66,2,164,165,0.012344755349394,1.00609756097561,1.00609756097561,2.01662612193788,36,25,63,0.524756610393524,2.68852459016393,1.86363636363636,3.52272727272727,88,61
"447",38,5.55,3,226,283,0.0111307767944936,1.25221238938053,1.25221238938053,1.55274283337244,49,32,104,0.579655110836029,2.79012345679012,1.66176470588235,3.04411764705882,136,81
"448",38,6.12,4,238,409,0.0145020033329788,1.71848739495798,1.71848739495798,1.75353565174321,62,41,108,0.437885940074921,2.31067961165049,1.59731543624161,3.54362416107383,149,103
"449",38,6.9,5,254,424,0.0131959789611279,1.66929133858268,1.66929133858268,1.59620041879344,59,45,122,0.438818275928497,2.44230769230769,1.52095808383234,3.06586826347305,167,104
"450",38,7.6,6,270,429,0.0118133002891367,1.58888888888889,1.58888888888889,1.93676114052011,75,44,135,0.484123140573502,2.26890756302521,1.50837988826816,2.92178770949721,179,119
"451",38,11.08,7,284,489,0.0121684168615936,1.72183098591549,1.72183098591549,1.96057193812801,77,50,130,0.48074197769165,2.23622047244094,1.57777777777778,3.22777777777778,180,127
"452",38,14.66,8,308,571,0.0120774990481831,1.8538961038961,1.8538961038961,1.81305757139006,72,59,152,0.449098438024521,2.35114503816794,1.45971563981043,3.1042654028436,211,131
"453",38,17.9,9,324,650,0.0124221228452395,2.00617283950617,2.00617283950617,1.80810741257544,75,70,165,0.42956805229187,2.23448275862069,1.37872340425532,2.9531914893617,235,145
"454",38,20.12,10,336,679,0.0120646766169154,2.02083333333333,2.02083333333333,1.79315107832586,87,73,172,0.45673269033432,2.1,1.37142857142857,2.90612244897959,245,160
"455",38,20.25,11,339,730,0.0127419664519733,2.15339233038348,2.15339233038348,1.80598821896561,87,73,177,0.433302670717239,2.11875,1.356,2.94,250,160
"456",38,21.5,12,349,753,0.0123999604782136,2.15759312320917,2.15759312320917,1.78717874239867,88,78,183,0.424523204565048,2.10240963855422,1.33716475095785,2.88505747126437,261,166
"457",39,1.52,1,120,86,0.0120448179271709,0.716666666666667,0.716666666666667,2.32491684857277,28,10,35,0.510478615760803,3.15789473684211,2.66666666666667,4.68888888888889,45,38
"458",39,4.41,2,211,270,0.012186865267434,1.27962085308057,1.27962085308057,2.08197437158833,49,33,86,0.466412872076035,2.57317073170732,1.77310924369748,3.15966386554622,119,82
"459",39,7.65,3,249,326,0.0105583624821868,1.30923694779116,1.30923694779116,1.50526030285977,60,45,110,0.572800934314728,2.37142857142857,1.60645161290323,2.8258064516129,155,105
"460",39,11.23,4,278,470,0.0122068410253746,1.69064748201439,1.69064748201439,1.82305651654104,70,53,133,0.474739670753479,2.26016260162602,1.49462365591398,3.24193548387097,186,123
"461",39,13.45,5,297,524,0.0119210119210119,1.76430976430976,1.76430976430976,1.58594943284856,74,57,148,0.466932624578476,2.26717557251908,1.44878048780488,2.83414634146341,205,131
"462",39,14.7,6,311,629,0.0130484389586143,2.02250803858521,2.02250803858521,1.82573157511131,73,62,151,0.417149603366852,2.3037037037037,1.46009389671362,3.1924882629108,213,135
"463",39,18.18,7,322,665,0.0128673980766626,2.06521739130435,2.06521739130435,1.81570257211299,83,70,163,0.44691276550293,2.10457516339869,1.38197424892704,2.92274678111588,233,153
"464",39,18.96,8,333,666,0.0120481927710843,2,2,1.79062148462617,79,72,169,0.439051628112793,2.20529801324503,1.38174273858921,2.97510373443983,241,151
"465",39,20.1,9,336,695,0.0123489694385217,2.06845238095238,2.06845238095238,1.75755006480635,84,73,174,0.449972540140152,2.14012738853503,1.36032388663968,2.85425101214575,247,157
"466",39,20.67,10,339,718,0.0125325094692011,2.11799410029499,2.11799410029499,1.8085321299502,84,76,174,0.432023525238037,2.11875,1.356,2.936,250,160
"467",39,21.37,11,346,737,0.0123481611795258,2.13005780346821,2.13005780346821,1.77345626461963,85,77,181,0.431848973035812,2.1358024691358,1.34108527131783,2.89922480620155,258,162
"468",39,21.5,12,349,753,0.0123999604782136,2.15759312320917,2.15759312320917,1.78717874239867,88,78,183,0.424523204565048,2.10240963855422,1.33716475095785,2.88505747126437,261,166
"469",40,1.25,1,132,104,0.012028683784409,0.787878787878788,0.787878787878788,1.52880114382165,26,11,46,0.580575108528137,3.56756756756757,2.31578947368421,4.26315789473684,57,37
"470",40,1.38,2,167,184,0.0132746555082606,1.10179640718563,1.10179640718563,2.39019369476409,40,27,58,0.47849714756012,2.49253731343284,1.96470588235294,3.94117647058824,85,67
"471",40,2.08,3,199,205,0.0104055631693823,1.03015075376884,1.03015075376884,1.68110058693301,49,24,76,0.54340273141861,2.72602739726027,1.99,3.48,100,73
"472",40,2.65,4,222,327,0.0133300721536016,1.47297297297297,1.47297297297297,1.62703800709244,60,33,100,0.499803572893143,2.38709677419355,1.66917293233083,3.40601503759398,133,93
"473",40,6.23,5,265,367,0.0104917095483133,1.38490566037736,1.38490566037736,1.92419164866674,69,44,112,0.523264646530151,2.34513274336283,1.69871794871795,3.30128205128205,156,113
"474",40,7.01,6,277,437,0.0114320096269555,1.57761732851986,1.57761732851986,1.59865317738803,75,48,137,0.489409267902374,2.2520325203252,1.4972972972973,2.66486486486486,185,123
"475",40,10.49,7,288,570,0.0137921022067364,1.97916666666667,1.97916666666667,1.79837872297598,72,55,144,0.429493635892868,2.26771653543307,1.44723618090452,3.12562814070352,199,127
"476",40,12.71,8,313,600,0.0122880314573605,1.91693290734824,1.91693290734824,1.83959708423779,78,62,149,0.429152816534042,2.23571428571429,1.48341232227488,3.17061611374408,211,140
"477",40,13.85,9,317,645,0.0128778500978317,2.03470031545741,2.03470031545741,1.82402714818877,81,63,165,0.422241508960724,2.20138888888889,1.39035087719298,2.98684210526316,228,144
"478",40,16.74,10,331,724,0.0132564313833196,2.18731117824773,2.18731117824773,1.80157939297098,84,74,170,0.419852316379547,2.09493670886076,1.35655737704918,3.00409836065574,244,158
"479",40,19.98,11,341,725,0.0125064688632051,2.12609970674487,2.12609970674487,1.79927966126265,86,74,178,0.418816685676575,2.13125,1.3531746031746,2.92857142857143,252,160
"480",40,21.5,12,349,753,0.0123999604782136,2.15759312320917,2.15759312320917,1.78717874239867,88,78,183,0.424523204565048,2.10240963855422,1.33716475095785,2.88505747126437,261,166
"481",41,3.58,1,171,227,0.0156174750601995,1.32748538011696,1.32748538011696,1.96918021318024,39,24,69,0.4119912981987,2.71428571428571,1.83870967741935,4.25806451612903,93,63
"482",41,5.1,2,202,220,0.010836904585981,1.08910891089109,1.08910891089109,1.72858765916679,49,30,75,0.501312017440796,2.55696202531646,1.92380952380952,3.60952380952381,105,79
"483",41,5.88,3,235,372,0.0135297326786688,1.58297872340426,1.58297872340426,1.99645077544292,66,30,117,0.480004876852036,2.44791666666667,1.59863945578231,3.15646258503401,147,96
"484",41,9.12,4,261,432,0.0127320954907162,1.6551724137931,1.6551724137931,1.53803279282169,62,51,127,0.468147188425064,2.30973451327434,1.46629213483146,2.91011235955056,178,113
"485",41,9.82,5,281,520,0.0132180986273513,1.85053380782918,1.85053380782918,1.86740737304816,69,55,132,0.434323251247406,2.26612903225806,1.50267379679144,3.22459893048128,187,124
"486",41,12.71,6,305,544,0.0117342536669543,1.78360655737705,1.78360655737705,1.8754837430107,75,61,140,0.462681114673615,2.24264705882353,1.51741293532338,3.22388059701493,201,136
"487",41,12.84,7,309,657,0.0138065817677468,2.12621359223301,2.12621359223301,1.80412416518645,78,68,160,0.43595951795578,2.11643835616438,1.35526315789474,3.07456140350877,228,146
"488",41,13.98,8,313,638,0.01306627344966,2.03833865814696,2.03833865814696,1.83848355306153,74,67,161,0.365747928619385,2.21985815602837,1.37280701754386,2.99122807017544,228,141
"489",41,16.2,9,326,698,0.0131760264275602,2.14110429447853,2.14110429447853,1.8000395695039,86,70,168,0.418349385261536,2.08974358974359,1.36974789915966,3.01680672268908,238,156
"490",41,16.77,10,330,672,0.0123791102514507,2.03636363636364,2.03636363636364,1.78060697659678,81,69,171,0.459284454584122,2.2,1.375,2.97083333333333,240,150
"491",41,20.25,11,339,697,0.0121659597493498,2.05604719764012,2.05604719764012,1.78604599416716,89,73,177,0.453658759593964,2.09259259259259,1.356,2.788,250,162
"492",41,21.5,12,349,753,0.0123999604782136,2.15759312320917,2.15759312320917,1.78717874239867,88,78,183,0.424523204565048,2.10240963855422,1.33716475095785,2.88505747126437,261,166
"493",42,1.14,1,114,92,0.0142834963514982,0.807017543859649,0.807017543859649,1.99106986359084,30,11,39,0.573605895042419,2.78048780487805,2.28,5,50,41
"494",42,3.36,2,187,199,0.0114427002472543,1.06417112299465,1.06417112299465,1.52401265935372,49,22,74,0.599239885807037,2.63380281690141,1.94791666666667,3.20833333333333,96,71
"495",42,3.93,3,209,311,0.0143080603606919,1.48803827751196,1.48803827751196,1.96382425307283,58,38,88,0.465638309717178,2.17708333333333,1.65873015873016,3.26984126984127,126,96
"496",42,7.17,4,234,327,0.0119951579179047,1.3974358974359,1.3974358974359,1.98012337567178,54,37,105,0.490236550569534,2.57142857142857,1.64788732394366,3.01408450704225,142,91
"497",42,8.69,5,251,411,0.0130996015936255,1.63745019920319,1.63745019920319,1.64324431569284,58,39,127,0.476900458335876,2.58762886597938,1.51204819277108,2.99397590361446,166,97
"498",42,8.82,6,261,390,0.0114942528735632,1.49425287356322,1.49425287356322,1.55915710220854,61,45,118,0.482274770736694,2.4622641509434,1.60122699386503,3.13496932515337,163,106
"499",42,9.52,7,277,461,0.0120598545492597,1.66425992779783,1.66425992779783,1.95433532809904,73,47,129,0.47333437204361,2.30833333333333,1.57386363636364,3.11931818181818,176,120
"500",42,13,8,291,498,0.0118023462495556,1.71134020618557,1.71134020618557,1.76564482960827,63,57,143,0.491395354270935,2.425,1.455,3.065,200,120
"501",42,14.25,9,306,593,0.0127075966998821,1.93790849673203,1.93790849673203,1.90478161899256,81,62,151,0.45534610748291,2.13986013986014,1.43661971830986,3,213,143
"502",42,17.83,10,329,689,0.0127696641708058,2.09422492401216,2.09422492401216,1.80563445980552,75,72,168,0.415618866682053,2.23809523809524,1.37083333333333,2.9625,240,147
"503",42,18.61,11,337,656,0.0115868305779285,1.94658753709199,1.94658753709199,1.82383316212811,83,74,173,0.464636921882629,2.14649681528662,1.36437246963563,2.91902834008097,247,157
"504",42,21.5,12,349,753,0.0123999604782136,2.15759312320917,2.15759312320917,1.78717874239867,88,78,183,0.424523204565048,2.10240963855422,1.33716475095785,2.88505747126437,261,166
"505",43,1.14,1,114,78,0.0121099208197485,0.684210526315789,0.684210526315789,1.93773852768251,22,11,32,0.585552275180817,3.45454545454545,2.65116279069767,4.88372093023256,43,33
"506",43,2.66,2,164,150,0.0112225048630854,0.914634146341463,0.914634146341463,1.77332626042226,43,22,53,0.584844470024109,2.52307692307692,2.18666666666667,3.38666666666667,75,65
"507",43,6.14,3,196,271,0.0141810570381999,1.38265306122449,1.38265306122449,1.75049049598788,48,26,89,0.516108155250549,2.64864864864865,1.70434782608696,3.46086956521739,115,74
"508",43,9.38,4,233,353,0.0130605298209264,1.51502145922747,1.51502145922747,1.54808982136052,60,37,107,0.472831040620804,2.4020618556701,1.61805555555556,3.35416666666667,144,97
"509",43,12.27,5,270,464,0.012777089357015,1.71851851851852,1.71851851851852,1.54917429264685,64,49,131,0.439069926738739,2.38938053097345,1.5,3.21111111111111,180,113
"510",43,13.52,6,288,516,0.0124854819976771,1.79166666666667,1.79166666666667,1.96505310766312,73,50,133,0.405404955148697,2.34146341463415,1.57377049180328,3.33879781420765,183,123
"511",43,14.09,7,295,504,0.0116222760290557,1.70847457627119,1.70847457627119,1.8053379885672,70,58,135,0.448477655649185,2.3046875,1.52849740932642,3.2020725388601,193,128
"512",43,14.87,8,307,563,0.0119861190947606,1.83387622149837,1.83387622149837,1.80221572215174,68,63,157,0.462408006191254,2.34351145038168,1.39545454545455,2.90909090909091,220,131
"513",43,15.57,9,315,596,0.0120513598220605,1.89206349206349,1.89206349206349,1.83433726027082,77,66,155,0.459745585918427,2.2027972027972,1.42533936651584,2.91402714932127,221,143
"514",43,17.79,10,326,637,0.0120245398773006,1.95398773006135,1.95398773006135,1.86505993272928,84,70,155,0.457617521286011,2.11688311688312,1.44888888888889,3.09333333333333,225,154
"515",43,17.92,11,329,633,0.0117317814515531,1.92401215805471,1.92401215805471,1.88079699088434,83,71,157,0.432529985904694,2.13636363636364,1.44298245614035,2.93859649122807,228,154
"516",43,21.5,12,349,753,0.0123999604782136,2.15759312320917,2.15759312320917,1.78717874239867,88,78,183,0.424523204565048,2.10240963855422,1.33716475095785,2.88505747126437,261,166
"517",44,0.57,1,142,141,0.0140845070422535,0.992957746478873,0.992957746478873,1.87547369725639,38,16,50,0.515064597129822,2.62962962962963,2.15151515151515,3.87878787878788,66,54
"518",44,1.71,2,160,159,0.0125,0.99375,0.99375,2.39011614043193,37,16,53,0.47502076625824,3.0188679245283,2.31884057971015,4.39130434782609,69,53
"519",44,4.95,3,202,259,0.0127579922171322,1.28217821782178,1.28217821782178,1.92376430431394,44,26,80,0.443724751472473,2.88571428571429,1.90566037735849,4.11320754716981,106,70
"520",44,5.73,4,226,330,0.0129793510324484,1.46017699115044,1.46017699115044,1.9839033913108,56,28,106,0.464605152606964,2.69047619047619,1.6865671641791,3.19402985074627,134,84
"521",44,6.43,5,246,377,0.0125103700016592,1.53252032520325,1.53252032520325,1.93085046620512,60,37,112,0.467325389385223,2.5360824742268,1.6510067114094,3.2751677852349,149,97
"522",44,9.32,6,274,467,0.01248629715783,1.7043795620438,1.7043795620438,1.8686076808769,71,54,125,0.439620971679688,2.192,1.53072625698324,3.30167597765363,179,125
"523",44,12.9,7,304,559,0.0121373979503213,1.83881578947368,1.83881578947368,1.851237687004,70,56,151,0.462056905031204,2.41269841269841,1.46859903381643,3.07729468599034,207,126
"524",44,14.15,8,316,627,0.0125979505726341,1.98417721518987,1.98417721518987,1.77538564989923,81,61,162,0.467757403850555,2.22535211267606,1.41704035874439,3.02690582959641,223,142
"525",44,16.37,9,329,677,0.012547260730966,2.05775075987842,2.05775075987842,1.81790861882891,82,70,168,0.418015241622925,2.16447368421053,1.38235294117647,2.95798319327731,238,152
"526",44,17.89,10,337,680,0.0120107390137064,2.01780415430267,2.01780415430267,1.75172948826397,87,70,175,0.421402484178543,2.14649681528662,1.37551020408163,2.89795918367347,245,157
"527",44,21.37,11,346,748,0.0125324620926531,2.16184971098266,2.16184971098266,1.79081017038907,88,77,181,0.443552672863007,2.0969696969697,1.34108527131783,2.89922480620155,258,165
"528",44,21.5,12,349,753,0.0123999604782136,2.15759312320917,2.15759312320917,1.78717874239867,88,78,183,0.424523204565048,2.10240963855422,1.33716475095785,2.88505747126437,261,166
"529",45,1.25,1,132,112,0.0129539671524404,0.848484848484849,0.848484848484849,1.99396874521873,31,9,50,0.547831654548645,3.3,2.23728813559322,3.93220338983051,59,40
"530",45,3.47,2,215,251,0.0109106715931319,1.16744186046512,1.16744186046512,1.4973987277118,54,32,92,0.5779669880867,2.5,1.73387096774194,2.99193548387097,124,86
"531",45,4.61,3,227,275,0.0107208295972867,1.21145374449339,1.21145374449339,1.85542546912273,52,28,97,0.518889248371124,2.8375,1.816,3.84,125,80
"532",45,7.5,4,258,407,0.0122764154073538,1.57751937984496,1.57751937984496,1.78200250191481,59,41,116,0.479109406471252,2.58,1.64331210191083,3.52229299363057,157,100
"533",45,8.07,5,268,385,0.0107608027279334,1.4365671641791,1.4365671641791,1.5916550592741,62,47,128,0.559264600276947,2.45871559633028,1.53142857142857,2.73142857142857,175,109
"534",45,9.59,6,284,492,0.0122430697257751,1.73239436619718,1.73239436619718,1.80124584083945,74,57,130,0.483566284179688,2.16793893129771,1.51871657754011,3.03743315508021,187,131
"535",45,12.83,7,296,498,0.0114063215758131,1.68243243243243,1.68243243243243,1.46908412437607,72,54,142,0.440446555614471,2.34920634920635,1.51020408163265,2.93367346938776,196,126
"536",45,16.31,8,308,579,0.0122467109437793,1.87987012987013,1.87987012987013,1.5742091900202,73,66,157,0.423349142074585,2.2158273381295,1.38116591928251,2.88340807174888,223,139
"537",45,19.89,9,330,629,0.011586994565718,1.90606060606061,1.90606060606061,1.79473638192515,81,73,162,0.459551692008972,2.14285714285714,1.40425531914894,2.99148936170213,235,154
"538",45,20.59,10,338,720,0.0126420030551507,2.1301775147929,2.1301775147929,1.81549998028309,84,76,177,0.429207116365433,2.1125,1.33596837944664,2.89723320158103,253,160
"539",45,20.72,11,342,744,0.0127591706539075,2.17543859649123,2.17543859649123,1.78873895449808,87,76,179,0.439790725708008,2.09815950920245,1.34117647058824,2.92549019607843,255,163
"540",45,21.5,12,349,753,0.0123999604782136,2.15759312320917,2.15759312320917,1.78717874239867,88,78,183,0.424523204565048,2.10240963855422,1.33716475095785,2.88505747126437,261,166
"541",46,3.58,1,171,190,0.0130718954248366,1.11111111111111,1.11111111111111,1.67791887905997,42,21,74,0.561357378959656,2.71428571428571,1.8,3.61052631578947,95,63
"542",46,4.83,2,211,255,0.011509817197021,1.2085308056872,1.2085308056872,1.87023852255042,52,29,84,0.52871972322464,2.60493827160494,1.86725663716814,3.46902654867257,113,81
"543",46,4.96,3,229,310,0.0118746648280089,1.35371179039301,1.35371179039301,1.49701213396686,61,37,112,0.580000042915344,2.33673469387755,1.53691275167785,2.86577181208054,149,98
"544",46,7.85,4,263,421,0.0122195454677387,1.60076045627376,1.60076045627376,1.64154153128371,69,43,129,0.478557467460632,2.34821428571429,1.52906976744186,2.98837209302326,172,112
"545",46,8.63,5,279,490,0.0126350532477244,1.75627240143369,1.75627240143369,1.62755274406191,77,49,141,0.491943001747131,2.21428571428571,1.46842105263158,2.80526315789474,190,126
"546",46,11.87,6,299,610,0.0136921730151961,2.04013377926421,2.04013377926421,1.8286364897268,75,62,150,0.39004835486412,2.18248175182482,1.41037735849057,3.17452830188679,212,137
"547",46,13.01,7,307,584,0.0124332034659684,1.90228013029316,1.90228013029316,1.82029895346879,74,63,152,0.460650146007538,2.24087591240876,1.42790697674419,3.06976744186047,215,137
"548",46,15.23,8,320,680,0.0133228840125392,2.125,2.125,1.83510687139675,79,71,162,0.448608338832855,2.13333333333333,1.37339055793991,2.97854077253219,233,150
"549",46,15.8,9,326,675,0.0127418593676262,2.07055214723926,2.07055214723926,1.80933983659696,83,74,166,0.459632396697998,2.07643312101911,1.35833333333333,2.86666666666667,240,157
"550",46,17.32,10,334,698,0.0125514736293179,2.08982035928144,2.08982035928144,1.82979498935167,88,73,167,0.41950598359108,2.07453416149068,1.39166666666667,2.95416666666667,240,161
"551",46,20.8,11,343,735,0.012531328320802,2.14285714285714,2.14285714285714,1.78897787726795,86,76,180,0.437024384737015,2.11728395061728,1.33984375,2.8828125,256,162
"552",46,21.5,12,349,753,0.0123999604782136,2.15759312320917,2.15759312320917,1.78717874239867,88,78,183,0.424523204565048,2.10240963855422,1.33716475095785,2.88505747126437,261,166
"553",47,1.52,1,120,89,0.0124649859943978,0.741666666666667,0.741666666666667,2.56001309408183,33,8,36,0.54993063211441,2.92682926829268,2.72727272727273,4.20454545454545,44,41
"554",47,1.65,2,167,197,0.014212538777866,1.17964071856287,1.17964071856287,2.18873734941778,42,21,62,0.460859596729279,2.65079365079365,2.01204819277108,4.02409638554217,83,63
"555",47,5.23,3,226,343,0.0134906588003933,1.51769911504425,1.51769911504425,1.69695345093705,56,36,102,0.455558478832245,2.45652173913043,1.63768115942029,3.21014492753623,138,92
"556",47,6.37,4,238,370,0.0131191717193206,1.5546218487395,1.5546218487395,1.81590401011435,60,41,106,0.437961995601654,2.35643564356436,1.61904761904762,3.70068027210884,147,101
"557",47,7.15,5,260,378,0.0112266112266112,1.45384615384615,1.45384615384615,1.62885222914067,64,44,114,0.483241647481918,2.40740740740741,1.64556962025316,3.04430379746835,158,108
"558",47,10.63,6,272,450,0.0122096809203386,1.65441176470588,1.65441176470588,1.88568518801748,62,48,135,0.453096270561218,2.47272727272727,1.48633879781421,3.07650273224044,183,110
"559",47,11.2,7,280,416,0.0106502816180236,1.48571428571429,1.48571428571429,1.91223508472051,64,46,127,0.490855544805527,2.54545454545455,1.61849710982659,3.1271676300578,173,110
"560",47,11.9,8,291,534,0.01265552790615,1.83505154639175,1.83505154639175,1.81135917911294,72,52,138,0.469397455453873,2.34677419354839,1.53157894736842,3.19473684210526,190,124
"561",47,15.14,9,308,538,0.0113794999788485,1.74675324675325,1.74675324675325,1.80808708686966,72,62,144,0.467910826206207,2.29850746268657,1.49514563106796,3.10679611650485,206,134
"562",47,16.39,10,321,592,0.0115264797507788,1.84423676012461,1.84423676012461,1.84831250219909,81,65,158,0.450245976448059,2.1986301369863,1.43946188340807,3.00448430493274,223,146
"563",47,18.61,11,337,709,0.012522961706938,2.10385756676558,2.10385756676558,1.78062179182887,83,73,177,0.457385510206223,2.16025641025641,1.348,2.892,250,156
"564",47,21.5,12,349,753,0.0123999604782136,2.15759312320917,2.15759312320917,1.78717874239867,88,78,183,0.424523204565048,2.10240963855422,1.33716475095785,2.88505747126437,261,166
"565",48,3.48,1,144,123,0.0119463869463869,0.854166666666667,0.854166666666667,2.16700394934783,32,13,58,0.568048119544983,3.2,2.02816901408451,3.3943661971831,71,45
"566",48,3.61,2,165,206,0.0152254249815225,1.24848484848485,1.24848484848485,2.15469491347384,40,20,60,0.449052691459656,2.75,2.0625,4.25,80,60
"567",48,5.83,3,222,349,0.0142268965798378,1.57207207207207,1.57207207207207,1.9860456346968,55,32,96,0.431030988693237,2.55172413793103,1.734375,3.6171875,128,87
"568",48,6.4,4,238,330,0.0117008828847995,1.38655462184874,1.38655462184874,1.87064993286343,57,35,107,0.495514184236526,2.58695652173913,1.67605633802817,3.22535211267606,142,92
"569",48,7.1,5,254,432,0.0134449596962435,1.7007874015748,1.7007874015748,1.88892517245084,62,47,110,0.448149740695953,2.3302752293578,1.61783439490446,3.5031847133758,157,109
"570",48,8.62,6,271,458,0.0125187918545852,1.690036900369,1.690036900369,1.84529684967494,70,51,125,0.452077031135559,2.2396694214876,1.53977272727273,3.38068181818182,176,121
"571",48,12.2,7,299,574,0.0128841103454468,1.91973244147157,1.91973244147157,1.61093938664313,79,58,153,0.430718749761581,2.18248175182482,1.41706161137441,2.93838862559242,211,137
"572",48,15.09,8,316,648,0.0130198915009042,2.0506329113924,2.0506329113924,1.78049007067512,81,62,158,0.429354101419449,2.20979020979021,1.43636363636364,3.12272727272727,220,143
"573",48,16.23,9,320,654,0.0128134796238245,2.04375,2.04375,1.80339412941813,77,67,163,0.440108627080917,2.22222222222222,1.39130434782609,3.03913043478261,230,144
"574",48,19.47,10,332,665,0.0121027918319805,2.00301204819277,2.00301204819277,1.78283011991123,84,71,170,0.428798705339432,2.14193548387097,1.37759336099585,2.98340248962656,241,155
"575",48,20.25,11,339,711,0.0124103262292507,2.09734513274336,2.09734513274336,1.81460887997723,86,77,175,0.438319116830826,2.07975460122699,1.3452380952381,2.86111111111111,252,163
"576",48,21.5,12,349,753,0.0123999604782136,2.15759312320917,2.15759312320917,1.78717874239867,88,78,183,0.424523204565048,2.10240963855422,1.33716475095785,2.88505747126437,261,166
"577",49,1.14,1,114,79,0.0122651762148735,0.692982456140351,0.692982456140351,1.87243123416108,25,11,27,0.553917646408081,3.16666666666667,3,5.73684210526316,38,36
"578",49,1.84,2,163,145,0.0109823524956449,0.889570552147239,0.889570552147239,1.41316373868107,32,22,59,0.593769311904907,3.01851851851852,2.01234567901235,3.23456790123457,81,54
"579",49,4.06,3,213,271,0.0120028346177695,1.27230046948357,1.27230046948357,1.67794366519648,48,27,93,0.464685916900635,2.84,1.775,3.29166666666667,120,75
"580",49,7.54,4,242,374,0.012825348924934,1.54545454545455,1.54545454545455,1.88533294745551,52,38,108,0.434116661548615,2.68888888888889,1.65753424657534,3.73972602739726,146,90
"581",49,10.78,5,261,376,0.0110816386678456,1.44061302681992,1.44061302681992,1.72859355234332,68,42,118,0.489489018917084,2.37272727272727,1.63125,3.29375,160,110
"582",49,12.3,6,277,499,0.013053942342908,1.8014440433213,1.8014440433213,1.79878734706935,66,51,133,0.422763347625732,2.36752136752137,1.5054347826087,3.17934782608696,184,117
"583",49,13.55,7,295,495,0.0114147353856797,1.67796610169492,1.67796610169492,1.79206546153455,73,56,140,0.463822036981583,2.28682170542636,1.50510204081633,3.07142857142857,196,129
"584",49,14.33,8,307,598,0.0127312597134402,1.94788273615635,1.94788273615635,1.84242088858228,80,61,152,0.455426961183548,2.17730496453901,1.44131455399061,3.07981220657277,213,141
"585",49,17.91,9,330,681,0.012544901906604,2.06363636363636,2.06363636363636,1.7575011915211,81,71,174,0.451586037874222,2.17105263157895,1.3469387755102,2.86530612244898,245,152
"586",49,20.8,10,343,739,0.0125995260259492,2.15451895043732,2.15451895043732,1.79002628376391,87,74,182,0.425653874874115,2.1304347826087,1.33984375,2.91796875,256,161
"587",49,20.93,11,346,748,0.0125324620926531,2.16184971098266,2.16184971098266,1.79115645912647,88,76,182,0.422355353832245,2.10975609756098,1.34108527131783,2.90697674418605,258,164
"588",49,21.5,12,349,753,0.0123999604782136,2.15759312320917,2.15759312320917,1.78717874239867,88,78,183,0.424523204565048,2.10240963855422,1.33716475095785,2.88505747126437,261,166
"589",50,1.25,1,132,145,0.0167707610455702,1.09848484848485,1.09848484848485,2.12785370481932,34,12,48,0.445208072662354,2.8695652173913,2.2,4.56666666666667,60,46
"590",50,4.14,2,200,286,0.0143718592964824,1.43,1.43,2.01790770911133,52,38,70,0.430039376020432,2.22222222222222,1.85185185185185,3.84259259259259,108,90
"591",50,5.28,3,218,342,0.0144590538198114,1.56880733944954,1.56880733944954,2.0098918584857,58,36,93,0.429521054029465,2.31914893617021,1.68992248062016,3.61240310077519,129,94
"592",50,6.06,4,244,335,0.0113000067462727,1.37295081967213,1.37295081967213,1.81146628069887,60,41,98,0.534649133682251,2.41584158415842,1.75539568345324,3.67625899280576,139,101
"593",50,6.76,5,258,395,0.0119144572135252,1.53100775193798,1.53100775193798,1.57073262955706,64,39,120,0.491732060909271,2.50485436893204,1.62264150943396,3.20125786163522,159,103
"594",50,10.24,6,276,560,0.0147562582345191,2.02898550724638,2.02898550724638,1.92099782744834,75,54,134,0.39309948682785,2.13953488372093,1.46808510638298,3.31382978723404,188,129
"595",50,12.46,7,298,514,0.0116150317492599,1.7248322147651,1.7248322147651,1.58987031281796,78,57,143,0.492965459823608,2.20740740740741,1.49,2.795,200,135
"596",50,13.03,8,302,592,0.0130250159512442,1.96026490066225,1.96026490066225,1.80192707897815,74,62,155,0.436695337295532,2.22058823529412,1.39170506912442,2.91244239631336,217,136
"597",50,13.16,9,305,559,0.0120578084555651,1.8327868852459,1.8327868852459,1.84404121776848,74,56,156,0.441033184528351,2.34615384615385,1.43867924528302,2.92452830188679,212,130
"598",50,16.4,10,317,588,0.0117398075310466,1.85488958990536,1.85488958990536,1.74042649117907,73,65,163,0.460946530103683,2.29710144927536,1.39035087719298,3,228,138
"599",50,19.98,11,341,726,0.0125237191650854,2.12903225806452,2.12903225806452,1.80018274518422,87,76,175,0.442363142967224,2.0920245398773,1.35856573705179,2.91235059760956,251,163
"600",50,21.5,12,349,753,0.0123999604782136,2.15759312320917,2.15759312320917,1.78717874239867,88,78,183,0.424523204565048,2.10240963855422,1.33716475095785,2.88505747126437,261,166
"601",51,3.24,1,156,174,0.0143920595533499,1.11538461538462,1.11538461538462,1.6670964630641,30,23,56,0.52422708272934,2.94339622641509,1.9746835443038,3.62025316455696,79,53
"602",51,3.37,2,179,141,0.00885066850794049,0.787709497206704,0.787709497206704,1.47390290183575,41,21,67,0.678864300251007,2.88709677419355,2.03409090909091,3.18181818181818,88,62
"603",51,4.15,3,213,232,0.0102754894144743,1.08920187793427,1.08920187793427,1.99529408970701,47,27,79,0.532188236713409,2.87837837837838,2.00943396226415,3.5377358490566,106,74
"604",51,5.29,4,222,268,0.0109249521014227,1.20720720720721,1.20720720720721,1.66835917069415,51,30,93,0.528945744037628,2.74074074074074,1.80487804878049,3.30081300813008,123,81
"605",51,8.18,5,258,353,0.010647603535125,1.36821705426357,1.36821705426357,1.54607664021573,62,35,120,0.489234328269958,2.65979381443299,1.66451612903226,3.30967741935484,155,97
"606",51,11.66,6,276,476,0.0125428194993412,1.72463768115942,1.72463768115942,1.8689445231601,77,48,132,0.451691627502441,2.208,1.53333333333333,3.13333333333333,180,125
"607",51,13.88,7,292,556,0.0130866638422068,1.9041095890411,1.9041095890411,1.87148909925667,70,61,143,0.402675539255142,2.22900763358779,1.43137254901961,3.01960784313725,204,131
"608",51,15.4,8,305,583,0.0125754961173425,1.91147540983607,1.91147540983607,1.8370865307022,78,62,145,0.459216147661209,2.17857142857143,1.47342995169082,3.1207729468599,207,140
"609",51,15.97,9,309,559,0.0117471525238516,1.80906148867314,1.80906148867314,1.61458928256692,74,59,158,0.470177412033081,2.32330827067669,1.42396313364055,2.76958525345622,217,133
"610",51,16.67,10,318,664,0.0131738190187092,2.08805031446541,2.08805031446541,1.81192152346893,82,65,164,0.41773909330368,2.16326530612245,1.38864628820961,3.04803493449782,229,147
"611",51,17.92,11,329,709,0.013140336570539,2.15501519756839,2.15501519756839,1.78309384214668,85,70,170,0.424513757228851,2.12258064516129,1.37083333333333,3.04166666666667,240,155
"612",51,21.5,12,349,753,0.0123999604782136,2.15759312320917,2.15759312320917,1.78717874239867,88,78,183,0.424523204565048,2.10240963855422,1.33716475095785,2.88505747126437,261,166
"613",52,0.13,1,110,95,0.0158465387823186,0.863636363636364,0.863636363636364,2.2862676453933,27,8,39,0.551634311676025,3.14285714285714,2.34042553191489,4.25531914893617,47,35
"614",52,2.35,2,195,231,0.0122125297383029,1.18461538461538,1.18461538461538,1.88890666309001,50,27,82,0.511009931564331,2.53246753246753,1.78899082568807,3.57798165137615,109,77
"615",52,5.93,3,251,438,0.0139601593625498,1.74501992031873,1.74501992031873,1.84581389076209,63,46,122,0.466391980648041,2.30275229357798,1.49404761904762,3.17857142857143,168,109
"616",52,7.18,4,274,460,0.0122991363867276,1.67883211678832,1.67883211678832,1.61695164990309,66,53,136,0.509421050548553,2.30252100840336,1.44973544973545,2.81481481481481,189,119
"617",52,7.96,5,285,548,0.0135408944897455,1.92280701754386,1.92280701754386,1.7979613671577,73,55,143,0.397329032421112,2.2265625,1.43939393939394,3.27777777777778,198,128
"618",52,10.85,6,303,560,0.0122396345594824,1.84818481848185,1.84818481848185,1.82161094236984,76,57,154,0.448249399662018,2.2781954887218,1.43601895734597,3.07109004739337,211,133
"619",52,14.33,7,315,608,0.0122940046506925,1.93015873015873,1.93015873015873,1.84370167505316,82,65,157,0.440800309181213,2.14285714285714,1.41891891891892,3.08558558558559,222,147
"620",52,15.85,8,327,687,0.012889063995047,2.10091743119266,2.10091743119266,1.79140445173886,81,69,169,0.426083147525787,2.18,1.37394957983193,2.97058823529412,238,150
"621",52,16.99,9,331,630,0.0115352925020599,1.90332326283988,1.90332326283988,1.52354273057268,80,68,169,0.459647297859192,2.23648648648649,1.39662447257384,2.87341772151899,237,148
"622",52,17.69,10,337,699,0.0123463331920305,2.07418397626113,2.07418397626113,1.79028037638647,85,73,176,0.429283827543259,2.13291139240506,1.35341365461847,2.90763052208835,249,158
"623",52,18.26,11,340,696,0.0120770432066632,2.04705882352941,2.04705882352941,1.78953249886542,88,74,175,0.460705250501633,2.09876543209877,1.36546184738956,2.96385542168675,249,162
"624",52,21.5,12,349,753,0.0123999604782136,2.15759312320917,2.15759312320917,1.78717874239867,88,78,183,0.424523204565048,2.10240963855422,1.33716475095785,2.88505747126437,261,166
"625",53,0.7,1,144,176,0.0170940170940171,1.22222222222222,1.22222222222222,1.9840431469992,38,15,60,0.474948346614838,2.71698113207547,1.92,4.73333333333333,75,53
"626",53,4.28,2,213,310,0.0137301798210648,1.45539906103286,1.45539906103286,1.89162238054984,56,33,97,0.479198753833771,2.39325842696629,1.63846153846154,3.42307692307692,130,89
"627",53,5.53,3,234,365,0.0133890906423095,1.55982905982906,1.55982905982906,2.0531151465221,63,36,103,0.465869754552841,2.36363636363636,1.68345323741007,3.43165467625899,139,99
"628",53,7.05,4,257,408,0.0124027237354086,1.5875486381323,1.5875486381323,1.85421963059617,60,47,125,0.474282771348953,2.4018691588785,1.49418604651163,3.25,172,107
"629",53,9.27,5,292,501,0.0117921197570965,1.71575342465753,1.71575342465753,1.75330579392922,65,53,143,0.468346774578094,2.47457627118644,1.48979591836735,3.09183673469388,196,118
"630",53,10.05,6,304,556,0.0120722598575647,1.82894736842105,1.82894736842105,1.83775496564497,82,60,138,0.437967419624329,2.14084507042254,1.53535353535354,3.29292929292929,198,142
"631",53,11.19,7,310,620,0.0129449838187702,2,2,1.84689015272862,81,68,155,0.444254696369171,2.08053691275168,1.39013452914798,3.04932735426009,223,149
"632",53,14.43,8,321,560,0.0109034267912773,1.74454828660436,1.74454828660436,1.6794826910019,82,64,146,0.49134886264801,2.1986301369863,1.52857142857143,2.94285714285714,210,146
"633",53,14.56,9,324,646,0.0123456790123457,1.99382716049383,1.99382716049383,1.74858076157515,79,71,166,0.448112487792969,2.16,1.36708860759494,2.87341772151899,237,150
"634",53,15.13,10,328,692,0.0129037070187216,2.10975609756098,2.10975609756098,1.81751626273591,81,70,166,0.428637325763702,2.17218543046358,1.38983050847458,3.04661016949153,236,151
"635",53,18.61,11,337,708,0.0125052988554472,2.10089020771513,2.10089020771513,1.76435797347013,84,70,178,0.42862743139267,2.18831168831169,1.35887096774194,2.97177419354839,248,154
"636",53,21.5,12,349,753,0.0123999604782136,2.15759312320917,2.15759312320917,1.78717874239867,88,78,183,0.424523204565048,2.10240963855422,1.33716475095785,2.88505747126437,261,166
"637",54,2.89,1,163,94,0.00711959403165947,0.576687116564417,0.576687116564417,2.00133283612661,31,12,44,0.619114995002747,3.7906976744186,2.91071428571429,4.53571428571429,56,43
"638",54,4.14,2,200,220,0.0110552763819095,1.1,1.1,1.69769829254312,50,25,81,0.507107377052307,2.66666666666667,1.88679245283019,3.40566037735849,106,75
"639",54,7.62,3,232,312,0.0116435288849082,1.3448275862069,1.3448275862069,1.65796974397623,53,37,97,0.486948370933533,2.57777777777778,1.73134328358209,3,134,90
"640",54,8.19,4,251,397,0.0126533864541833,1.58167330677291,1.58167330677291,1.97885655906338,62,36,117,0.466372489929199,2.56122448979592,1.64052287581699,3.31372549019608,153,98
"641",54,10.41,5,279,498,0.0128413398313607,1.78494623655914,1.78494623655914,1.60551594388705,69,54,136,0.461436063051224,2.26829268292683,1.46842105263158,3,190,123
"642",54,11.93,6,292,465,0.0109447818104787,1.59246575342466,1.59246575342466,1.53398539995096,78,51,138,0.516917586326599,2.26356589147287,1.54497354497354,2.84656084656085,189,129
"643",54,12.06,7,299,550,0.0123454018989473,1.83946488294314,1.83946488294314,1.8211789086879,74,57,149,0.412084311246872,2.2824427480916,1.45145631067961,3.07281553398058,206,131
"644",54,15.64,8,322,644,0.0124610591900312,2,2,1.79563333267696,82,68,162,0.445939093828201,2.14666666666667,1.4,2.9304347826087,230,150
"645",54,16.42,9,330,696,0.0128212213318596,2.10909090909091,2.10909090909091,1.76906152992467,86,70,171,0.403441458940506,2.11538461538462,1.36929460580913,2.97510373443983,241,156
"646",54,17.56,10,334,696,0.0125155095214975,2.08383233532934,2.08383233532934,1.79819271008071,87,72,173,0.425031393766403,2.10062893081761,1.36326530612245,2.9469387755102,245,159
"647",54,18.26,11,340,708,0.0122852680895367,2.08235294117647,2.08235294117647,1.79337245577981,83,75,176,0.43916180729866,2.15189873417722,1.35458167330677,2.91235059760956,251,158
"648",54,21.5,12,349,753,0.0123999604782136,2.15759312320917,2.15759312320917,1.78717874239867,88,78,183,0.424523204565048,2.10240963855422,1.33716475095785,2.88505747126437,261,166
"649",55,0.57,1,142,141,0.0140845070422535,0.992957746478873,0.992957746478873,1.789106709668,30,14,52,0.548714876174927,3.22727272727273,2.15151515151515,3.75757575757576,66,44
"650",55,1.35,2,185,191,0.0112220916568743,1.03243243243243,1.03243243243243,2.0692777236413,43,22,64,0.502494394779205,2.84615384615385,2.15116279069767,4.16279069767442,86,65
"651",55,2.6,3,218,314,0.0132752716357333,1.44036697247706,1.44036697247706,1.93044457429476,58,35,91,0.456788331270218,2.34408602150538,1.73015873015873,3.6984126984127,126,93
"652",55,4.12,4,239,340,0.0119545726240287,1.42259414225941,1.42259414225941,1.99879808902842,62,36,95,0.439442038536072,2.43877551020408,1.82442748091603,3.49618320610687,131,98
"653",55,7.01,5,271,451,0.0123274566078994,1.66420664206642,1.66420664206642,1.84462127553128,62,48,134,0.45096880197525,2.46363636363636,1.48901098901099,3.08791208791209,182,110
"654",55,8.15,6,277,506,0.01323706377858,1.82671480144404,1.82671480144404,1.86974001203672,65,56,136,0.400275766849518,2.28925619834711,1.44270833333333,3.13020833333333,192,121
"655",55,11.63,7,290,504,0.0120272043908841,1.73793103448276,1.73793103448276,1.85759909221608,72,51,144,0.425640493631363,2.35772357723577,1.48717948717949,3.24102564102564,195,123
"656",55,14.87,8,307,608,0.012944157033063,1.98045602605863,1.98045602605863,1.82374019725113,79,62,152,0.417880833148956,2.17730496453901,1.43457943925234,3.08878504672897,214,141
"657",55,15.57,9,315,612,0.0123748862602366,1.94285714285714,1.94285714285714,1.85146792103778,80,67,158,0.468290776014328,2.14285714285714,1.4,2.82666666666667,225,147
"658",55,19.15,10,335,705,0.0126016623469479,2.1044776119403,2.1044776119403,1.81247175284681,82,71,173,0.43529200553894,2.18954248366013,1.37295081967213,2.95081967213115,244,153
"659",55,19.28,11,338,711,0.0124839780169614,2.10355029585799,2.10355029585799,1.81038112685007,84,74,174,0.437239050865173,2.13924050632911,1.36290322580645,2.94354838709677,248,158
"660",55,21.5,12,349,753,0.0123999604782136,2.15759312320917,2.15759312320917,1.78717874239867,88,78,183,0.424523204565048,2.10240963855422,1.33716475095785,2.88505747126437,261,166
"661",56,1.14,1,114,46,0.00714174817574911,0.403508771929825,0.403508771929825,2.10388955799216,20,3,28,0.713846862316132,4.95652173913044,3.67741935483871,3.67741935483871,31,23
"662",56,2.66,2,164,121,0.00905282058955559,0.73780487804878,0.73780487804878,1.6573539142428,32,12,56,0.538590252399445,3.72727272727273,2.41176470588235,3.88235294117647,68,44
"663",56,3.44,3,199,269,0.0136541292320187,1.35175879396985,1.35175879396985,1.90094084464241,51,31,82,0.530437707901001,2.42682926829268,1.76106194690265,3.60176991150442,113,82
"664",56,7.02,4,248,409,0.0133537939140656,1.6491935483871,1.6491935483871,1.94310202118779,55,47,116,0.441368073225021,2.43137254901961,1.52147239263804,2.97546012269939,163,102
"665",56,8.27,5,273,445,0.0119855634561517,1.63003663003663,1.63003663003663,1.89440357341447,60,51,121,0.431117296218872,2.45945945945946,1.58720930232558,3.30232558139535,172,111
"666",56,8.97,6,287,459,0.0111839380132063,1.5993031358885,1.5993031358885,1.83041999042249,74,52,133,0.476034820079803,2.27777777777778,1.55135135135135,3.03243243243243,185,126
"667",56,9.1,7,291,498,0.0118023462495556,1.71134020618557,1.71134020618557,1.93491241539003,80,54,127,0.441117912530899,2.17164179104478,1.60773480662983,3.40331491712707,181,134
"668",56,9.67,8,296,551,0.0126202473660101,1.86148648648649,1.86148648648649,1.76302977559349,83,51,146,0.462202042341232,2.2089552238806,1.50253807106599,3.26395939086294,197,134
"669",56,12.91,9,311,601,0.0124675863499637,1.93247588424437,1.93247588424437,1.77601078411833,76,63,161,0.457991510629654,2.23741007194245,1.38839285714286,2.96875,224,139
"670",56,15.13,10,328,667,0.0124375326322071,2.03353658536585,2.03353658536585,1.75956972508207,81,69,175,0.440708816051483,2.18666666666667,1.34426229508197,2.90163934426229,244,150
"671",56,18.02,11,340,720,0.0124934929724102,2.11764705882353,2.11764705882353,1.82247636946703,87,74,176,0.423526227474213,2.11180124223602,1.36,2.924,250,161
"672",56,21.5,12,349,753,0.0123999604782136,2.15759312320917,2.15759312320917,1.78717874239867,88,78,183,0.424523204565048,2.10240963855422,1.33716475095785,2.88505747126437,261,166
"673",57,0.57,1,142,140,0.0139846169213865,0.985915492957746,0.985915492957746,1.93651297467524,35,13,54,0.517933666706085,2.95833333333333,2.11940298507463,4.55223880597015,67,48
"674",57,0.7,2,168,181,0.0129027658967779,1.07738095238095,1.07738095238095,1.76517919722514,38,23,62,0.490674823522568,2.75409836065574,1.97647058823529,3.70588235294118,85,61
"675",57,3.59,3,222,323,0.0131670131670132,1.45495495495495,1.45495495495495,1.92579589316342,52,28,93,0.451504349708557,2.775,1.83471074380165,3.91735537190083,121,80
"676",57,4.73,4,229,315,0.0120661916800735,1.37554585152838,1.37554585152838,2.09956274193659,58,37,99,0.481058210134506,2.41052631578947,1.68382352941176,3.19852941176471,136,95
"677",57,5.98,5,253,358,0.0112303155781417,1.41501976284585,1.41501976284585,1.60229697712862,64,42,110,0.501131355762482,2.38679245283019,1.66447368421053,3.38157894736842,152,106
"678",57,6.68,6,261,402,0.0118479221927498,1.54022988505747,1.54022988505747,2.01519324664082,74,47,110,0.502509236335754,2.15702479338843,1.66242038216561,3.03821656050955,157,121
"679",57,10.26,7,295,575,0.0132595411045774,1.94915254237288,1.94915254237288,1.75192674744721,72,63,148,0.44142609834671,2.18518518518519,1.39810426540284,2.98104265402844,211,135
"680",57,11.04,8,304,600,0.0130276185513288,1.97368421052632,1.97368421052632,1.83486216882482,79,64,148,0.441038876771927,2.12587412587413,1.43396226415094,3.13207547169811,212,143
"681",57,12.56,9,315,628,0.0126984126984127,1.99365079365079,1.99365079365079,1.85055799364423,83,69,157,0.421237945556641,2.07236842105263,1.39380530973451,2.91592920353982,226,152
"682",57,15.8,10,328,679,0.012661296337734,2.07012195121951,2.07012195121951,1.82697184370808,82,73,167,0.453613668680191,2.11612903225806,1.36666666666667,2.94583333333333,240,155
"683",57,18.02,11,340,723,0.0125455491931286,2.12647058823529,2.12647058823529,1.79581151892417,83,75,178,0.417045921087265,2.15189873417722,1.34387351778656,2.87747035573123,253,158
"684",57,21.5,12,349,753,0.0123999604782136,2.15759312320917,2.15759312320917,1.78717874239867,88,78,183,0.424523204565048,2.10240963855422,1.33716475095785,2.88505747126437,261,166
"685",58,0.13,1,110,54,0.00900750625521268,0.490909090909091,0.490909090909091,1.71755658691046,24,7,30,0.722908139228821,3.54838709677419,2.97297297297297,3.54054054054054,37,31
"686",58,0.91,2,167,189,0.0136353798427242,1.13173652694611,1.13173652694611,1.38712729064893,43,25,69,0.549816608428955,2.45588235294118,1.77659574468085,3.34042553191489,94,68
"687",58,2.43,3,200,295,0.0148241206030151,1.475,1.475,1.80328134549684,42,31,92,0.474668204784393,2.73972602739726,1.6260162601626,3.53658536585366,123,73
"688",58,5.91,4,223,272,0.0109885670423787,1.21973094170404,1.21973094170404,1.67282399939534,60,34,94,0.580808043479919,2.37234042553191,1.7421875,3.0234375,128,94
"689",58,6.61,5,251,346,0.0110278884462151,1.37848605577689,1.37848605577689,1.56736881210213,60,34,115,0.527711391448975,2.67021276595745,1.68456375838926,3.3489932885906,149,94
"690",58,9.5,6,279,510,0.0131507697068152,1.82795698924731,1.82795698924731,1.88987434844194,72,55,132,0.44298729300499,2.19685039370079,1.49197860962567,3.17647058823529,187,127
"691",58,10.64,7,284,485,0.0120688797093515,1.70774647887324,1.70774647887324,1.79009103834339,70,55,133,0.460767328739166,2.272,1.51063829787234,3.1063829787234,188,125
"692",58,13.88,8,302,573,0.0126069833447009,1.89735099337748,1.89735099337748,1.80486707544882,75,61,147,0.461873590946198,2.22058823529412,1.45192307692308,2.96153846153846,208,136
"693",58,17.46,9,323,679,0.0130569390227487,2.10216718266254,2.10216718266254,1.78849699765316,79,71,166,0.432311862707138,2.15333333333333,1.36286919831224,3.0084388185654,237,150
"694",58,19.68,10,335,722,0.0129055322191438,2.15522388059701,2.15522388059701,1.79629098799179,84,74,173,0.440716594457626,2.12025316455696,1.35627530364372,2.96356275303644,247,158
"695",58,20.25,11,339,729,0.0127245117034089,2.15044247787611,2.15044247787611,1.80621843042186,90,71,174,0.437874555587769,2.1055900621118,1.38367346938776,3.00408163265306,245,161
"696",58,21.5,12,349,753,0.0123999604782136,2.15759312320917,2.15759312320917,1.78717874239867,88,78,183,0.424523204565048,2.10240963855422,1.33716475095785,2.88505747126437,261,166
"697",59,1.14,1,114,56,0.00869430212699891,0.491228070175439,0.491228070175439,1.8217167170013,17,6,36,0.715401768684387,4.95652173913044,2.71428571428571,3.83333333333333,42,23
"698",59,1.27,2,147,164,0.0152828254589507,1.1156462585034,1.1156462585034,1.91589210984886,35,16,58,0.544430434703827,2.88235294117647,1.98648648648649,4.05405405405405,74,51
"699",59,4.85,3,218,266,0.0112459307487422,1.22018348623853,1.22018348623853,2.09013744433401,56,34,94,0.521658957004547,2.42222222222222,1.703125,2.921875,128,90
"700",59,5.55,4,239,337,0.0118490911008755,1.41004184100418,1.41004184100418,1.5189876006243,62,36,117,0.509016573429108,2.43877551020408,1.56209150326797,2.86274509803922,153,98
"701",59,6.33,5,259,440,0.0131693154948969,1.6988416988417,1.6988416988417,1.90652289402843,73,44,116,0.511038243770599,2.21367521367521,1.61875,3.25,160,117
"702",59,9.57,6,279,483,0.0124545524870426,1.73118279569892,1.73118279569892,1.82693280706954,68,51,141,0.471661806106567,2.34453781512605,1.453125,3.05729166666667,192,119
"703",59,10.82,7,293,447,0.0104492963672916,1.52559726962457,1.52559726962457,1.78320751210996,67,53,141,0.524518430233002,2.44166666666667,1.51030927835052,2.95876288659794,194,120
"704",59,14.3,8,305,605,0.0130500431406385,1.98360655737705,1.98360655737705,1.74323117455548,71,60,156,0.426912128925323,2.32824427480916,1.41203703703704,3.15740740740741,216,131
"705",59,16.52,9,323,646,0.0124223602484472,2,2,1.77281052085584,82,72,164,0.441313058137894,2.0974025974026,1.36864406779661,2.94915254237288,236,154
"706",59,18.04,10,333,671,0.0121386446687652,2.01501501501502,2.01501501501502,1.80110354977304,86,70,169,0.424177259206772,2.13461538461538,1.39330543933054,2.86610878661088,239,156
"707",59,18.61,11,337,673,0.0118870990532712,1.99703264094955,1.99703264094955,1.82170738025098,86,74,171,0.44661083817482,2.10625,1.37551020408163,2.89795918367347,245,160
"708",59,21.5,12,349,753,0.0123999604782136,2.15759312320917,2.15759312320917,1.78717874239867,88,78,183,0.424523204565048,2.10240963855422,1.33716475095785,2.88505747126437,261,166
"709",60,1.14,1,114,61,0.00947057910262382,0.535087719298246,0.535087719298246,1.76122710968883,19,5,34,0.61529153585434,4.75,2.92307692307692,3.38461538461538,39,24
"710",60,2.66,2,164,149,0.0111476881639982,0.908536585365854,0.908536585365854,1.55569580587749,39,18,65,0.587293386459351,2.87719298245614,1.97590361445783,3.31325301204819,83,57
"711",60,3.44,3,199,229,0.0116237754428709,1.15075376884422,1.15075376884422,1.83769628054102,44,23,85,0.487156957387924,2.97014925373134,1.84259259259259,3.94444444444444,108,67
"712",60,3.57,4,214,322,0.0141283840112325,1.50467289719626,1.50467289719626,2.00027619035116,52,36,91,0.402400523424149,2.43181818181818,1.68503937007874,3.37007874015748,127,88
"713",60,6.81,5,245,333,0.011140849782536,1.35918367346939,1.35918367346939,1.92156343577363,60,43,110,0.570534586906433,2.37864077669903,1.60130718954248,2.91503267973856,153,103
"714",60,8.06,6,269,482,0.0133718026965544,1.79182156133829,1.79182156133829,1.92072284958094,65,48,128,0.412258356809616,2.38053097345133,1.52840909090909,3.23295454545455,176,113
"715",60,10.95,7,296,567,0.0129867155290884,1.91554054054054,1.91554054054054,1.84505714044151,78,55,151,0.433787792921066,2.22556390977444,1.4368932038835,3.06310679611651,206,133
"716",60,14.43,8,308,624,0.0131985278565083,2.02597402597403,2.02597402597403,1.76596353899974,77,66,153,0.436873346567154,2.15384615384615,1.40639269406393,3.01826484018265,219,143
"717",60,16.65,9,320,640,0.0125391849529781,2,2,1.80559909386727,80,70,161,0.446409910917282,2.13333333333333,1.38528138528139,2.95238095238095,231,150
"718",60,17.22,10,323,670,0.0128838720843028,2.07430340557276,2.07430340557276,1.81104524919029,82,69,165,0.430807530879974,2.13907284768212,1.38034188034188,2.9957264957265,234,151
"719",60,20.8,11,343,744,0.0126847731573833,2.16909620991254,2.16909620991254,1.78660594279453,86,76,181,0.431821942329407,2.11728395061728,1.33463035019455,2.90661478599222,257,162
"720",60,21.5,12,349,753,0.0123999604782136,2.15759312320917,2.15759312320917,1.78717874239867,88,78,183,0.424523204565048,2.10240963855422,1.33716475095785,2.88505747126437,261,166
"721",61,0.7,1,144,151,0.0146658896658897,1.04861111111111,1.04861111111111,1.70790153128923,29,19,53,0.519516706466675,3,2,4.27777777777778,72,48
"722",61,3.94,2,199,276,0.0140094411451195,1.38693467336683,1.38693467336683,2.01681465573434,52,31,77,0.458707451820374,2.39759036144578,1.84259259259259,3.71296296296296,108,83
"723",61,7.42,3,227,344,0.0134107832053331,1.51541850220264,1.51541850220264,1.91569353648009,58,36,100,0.460291057825089,2.41489361702128,1.66911764705882,3.44117647058824,136,94
"724",61,8.94,4,252,411,0.0129956365016126,1.63095238095238,1.63095238095238,1.92210955959199,57,48,110,0.441845595836639,2.4,1.59493670886076,3.22784810126582,158,105
"725",61,10.08,5,256,433,0.013265931372549,1.69140625,1.69140625,1.7912142517424,59,41,129,0.459634989500046,2.56,1.50588235294118,3.36470588235294,170,100
"726",61,13.66,6,284,547,0.0136117055691037,1.92605633802817,1.92605633802817,1.83510100368988,76,53,140,0.451025873422623,2.2015503875969,1.47150259067358,3.23316062176166,193,129
"727",61,15.88,7,304,593,0.01287562966823,1.95065789473684,1.95065789473684,1.88629303091975,75,61,149,0.46835196018219,2.23529411764706,1.44761904761905,3.03809523809524,210,136
"728",61,16.01,8,309,519,0.0109065691589963,1.67961165048544,1.67961165048544,1.58950126315774,76,60,158,0.511380612850189,2.27205882352941,1.41743119266055,2.63302752293578,218,136
"729",61,17.26,9,323,685,0.0131723169817126,2.12074303405573,2.12074303405573,1.85368911755441,84,69,163,0.425935328006744,2.11111111111111,1.39224137931034,3.03879310344828,232,153
"730",61,18.04,10,333,681,0.0123195484641268,2.04504504504505,2.04504504504505,1.82140001619972,87,70,167,0.397767394781113,2.12101910828025,1.40506329113924,3,237,157
"731",61,20.93,11,346,749,0.0125492167211192,2.16473988439306,2.16473988439306,1.78853568459799,88,78,180,0.437451064586639,2.08433734939759,1.34108527131783,2.9031007751938,258,166
"732",61,21.5,12,349,753,0.0123999604782136,2.15759312320917,2.15759312320917,1.78717874239867,88,78,183,0.424523204565048,2.10240963855422,1.33716475095785,2.88505747126437,261,166
"733",62,3.24,1,156,172,0.0142266335814723,1.1025641025641,1.1025641025641,2.07381029165394,36,19,61,0.475814640522003,2.83636363636364,1.95,4.175,80,55
"734",62,3.37,2,179,223,0.0139978657962463,1.24581005586592,1.24581005586592,1.9207221357449,51,24,74,0.520913362503052,2.38666666666667,1.8265306122449,3.30612244897959,98,75
"735",62,6.26,3,233,334,0.0123575551280154,1.43347639484979,1.43347639484979,1.85770737256126,62,37,100,0.497077703475952,2.35353535353535,1.7007299270073,3.37226277372263,137,99
"736",62,9.84,4,272,471,0.0127794660299544,1.73161764705882,1.73161764705882,1.84743956526865,65,54,123,0.447196364402771,2.28571428571429,1.53672316384181,3.07344632768362,177,119
"737",62,10.41,5,286,548,0.0134462029198871,1.91608391608392,1.91608391608392,1.86872968726686,71,60,130,0.4538833796978,2.18320610687023,1.50526315789474,3.28421052631579,190,131
"738",62,11.93,6,295,489,0.0112763749567624,1.65762711864407,1.65762711864407,1.52812445801821,74,56,146,0.533520698547363,2.26923076923077,1.46039603960396,2.8960396039604,202,130
"739",62,12.71,7,303,560,0.0122396345594824,1.84818481848185,1.84818481848185,1.77852823849601,77,59,155,0.454467564821243,2.22794117647059,1.41588785046729,3.08878504672897,214,136
"740",62,13.41,8,313,614,0.0125747521913656,1.96166134185304,1.96166134185304,1.8256278285316,84,64,155,0.438553750514984,2.11486486486486,1.42922374429224,3,219,148
"741",62,15.63,9,326,674,0.0127229825389335,2.06748466257669,2.06748466257669,1.80269224086991,85,70,171,0.434195250272751,2.10322580645161,1.35269709543568,2.87551867219917,241,155
"742",62,19.11,10,336,691,0.0122778962331201,2.05654761904762,2.05654761904762,1.80339788260883,85,74,174,0.422431468963623,2.11320754716981,1.35483870967742,2.84677419354839,248,159
"743",62,20.25,11,339,735,0.012829240194795,2.16814159292035,2.16814159292035,1.77915090329849,87,72,179,0.417715728282928,2.13207547169811,1.35059760956175,2.95219123505976,251,159
"744",62,21.5,12,349,753,0.0123999604782136,2.15759312320917,2.15759312320917,1.78717874239867,88,78,183,0.424523204565048,2.10240963855422,1.33716475095785,2.88505747126437,261,166
"745",63,1.14,1,114,61,0.00947057910262382,0.535087719298246,0.535087719298246,2.14137975939603,18,13,24,0.581698417663574,3.67741935483871,3.08108108108108,5.10810810810811,37,31
"746",63,2.66,2,164,153,0.0114469549603471,0.932926829268293,0.932926829268293,1.73339294079989,34,18,57,0.554893434047699,3.15384615384615,2.18666666666667,3.8,75,52
"747",63,3.23,3,191,222,0.012234775420226,1.16230366492147,1.16230366492147,2.0719925974822,42,28,68,0.45077508687973,2.72857142857143,1.98958333333333,3.79166666666667,96,70
"748",63,4.01,4,216,275,0.0118432385874246,1.27314814814815,1.27314814814815,1.82514044280961,55,34,83,0.468740493059158,2.42696629213483,1.84615384615385,3.24786324786325,117,89
"749",63,4.14,5,228,272,0.0105108586444084,1.19298245614035,1.19298245614035,2.16586928075607,59,26,88,0.504210352897644,2.68235294117647,2,3.43859649122807,114,85
"750",63,7.38,6,253,329,0.010320597277119,1.300395256917,1.300395256917,1.82491044867603,62,42,104,0.507792830467224,2.43269230769231,1.73287671232877,3.41780821917808,146,104
"751",63,8.08,7,270,507,0.0139611730689798,1.87777777777778,1.87777777777778,1.79289973497028,62,55,128,0.453287124633789,2.30769230769231,1.47540983606557,3.21857923497268,183,117
"752",63,9.33,8,285,534,0.0131949592290586,1.87368421052632,1.87368421052632,1.85138049848107,72,54,132,0.460937142372131,2.26190476190476,1.53225806451613,3.3494623655914,186,126
"753",63,12.81,9,299,552,0.0123902942694889,1.84615384615385,1.84615384615385,1.84914752513803,79,57,148,0.458357959985733,2.19852941176471,1.45853658536585,3.05853658536585,205,136
"754",63,15.7,10,318,607,0.0120429339523441,1.90880503144654,1.90880503144654,1.81106547787659,82,65,161,0.440634936094284,2.16326530612245,1.4070796460177,2.99557522123894,226,147
"755",63,17.92,11,329,658,0.0121951219512195,2,2,1.52868906056871,80,70,176,0.465583771467209,2.19333333333333,1.33739837398374,2.82113821138211,246,150
"756",63,21.5,12,349,753,0.0123999604782136,2.15759312320917,2.15759312320917,1.78717874239867,88,78,183,0.424523204565048,2.10240963855422,1.33716475095785,2.88505747126437,261,166
"757",64,2.89,1,163,145,0.0109823524956449,0.889570552147239,0.889570552147239,1.99066965289948,32,12,54,0.476313918828964,3.70454545454545,2.46969696969697,5.10606060606061,66,44
"758",64,3.02,2,192,248,0.0135253054101222,1.29166666666667,1.29166666666667,1.83384542233548,49,27,72,0.489651054143906,2.52631578947368,1.93939393939394,4.2020202020202,99,76
"759",64,4.54,3,229,346,0.0132536581628744,1.51091703056769,1.51091703056769,1.84887315363134,49,39,103,0.416255980730057,2.60227272727273,1.61267605633803,3.40845070422535,142,88
"760",64,6.76,4,261,407,0.0119952844090775,1.55938697318008,1.55938697318008,1.90994165821981,65,44,131,0.483902722597122,2.39449541284404,1.49142857142857,2.89714285714286,175,109
"761",64,7.46,5,273,511,0.013763197586727,1.87179487179487,1.87179487179487,1.85649068973077,71,48,133,0.406566321849823,2.29411764705882,1.50828729281768,3.22651933701657,181,119
"762",64,10.7,6,288,520,0.0125822686798297,1.80555555555556,1.80555555555556,1.89026895293501,72,56,140,0.437278091907501,2.25,1.46938775510204,2.9234693877551,196,128
"763",64,14.18,7,300,506,0.0112820512820513,1.68666666666667,1.68666666666667,1.54200016151261,75,57,142,0.483273863792419,2.27272727272727,1.50753768844221,2.99497487437186,199,132
"764",64,15.43,8,313,617,0.0126361923486524,1.97124600638978,1.97124600638978,1.75467148096011,80,66,158,0.443012654781342,2.14383561643836,1.39732142857143,2.98214285714286,224,146
"765",64,16.57,9,316,622,0.0124974884468555,1.96835443037975,1.96835443037975,1.86910587561181,84,65,153,0.441075354814529,2.12080536912752,1.44954128440367,3.10091743119266,218,149
"766",64,17.35,10,326,660,0.0124587069372345,2.02453987730061,2.02453987730061,1.84282399662739,85,67,166,0.437109768390656,2.14473684210526,1.39914163090129,2.95708154506438,233,152
"767",64,20.93,11,346,748,0.0125324620926531,2.16184971098266,2.16184971098266,1.78977090217275,85,78,183,0.440071046352386,2.12269938650307,1.32567049808429,2.88505747126437,261,163
"768",64,21.5,12,349,753,0.0123999604782136,2.15759312320917,2.15759312320917,1.78717874239867,88,78,183,0.424523204565048,2.10240963855422,1.33716475095785,2.88505747126437,261,166
"769",65,2.22,1,171,155,0.0106639146886825,0.906432748538012,0.906432748538012,1.99247037045571,40,16,68,0.58899062871933,3.05357142857143,2.03571428571429,3.45238095238095,84,56
"770",65,5.8,2,237,394,0.0140885360795251,1.66244725738397,1.66244725738397,1.9706675070754,65,40,110,0.467433452606201,2.25714285714286,1.58,3.42,150,105
"771",65,7.32,3,255,378,0.0116720704029643,1.48235294117647,1.48235294117647,1.6116331287663,63,43,124,0.504468679428101,2.40566037735849,1.52694610778443,2.90419161676647,167,106
"772",65,8.57,4,281,471,0.0119725470259278,1.67615658362989,1.67615658362989,1.83869148243663,70,54,131,0.444036573171616,2.26612903225806,1.51891891891892,3.07567567567568,185,124
"773",65,9.35,5,294,516,0.0119802187086439,1.75510204081633,1.75510204081633,1.80678828096286,73,60,147,0.468556612730026,2.21052631578947,1.42028985507246,2.8743961352657,207,133
"774",65,12.24,6,312,596,0.0122846071399126,1.91025641025641,1.91025641025641,1.90338924029556,81,60,151,0.433881044387817,2.21276595744681,1.47867298578199,3.1042654028436,211,141
"775",65,13.38,7,317,602,0.0120193267579763,1.89905362776025,1.89905362776025,1.8069062725462,79,67,159,0.451562404632568,2.17123287671233,1.40265486725664,2.88495575221239,226,146
"776",65,13.95,8,320,604,0.011833855799373,1.8875,1.8875,1.88354181935689,87,67,152,0.465557932853699,2.07792207792208,1.46118721461187,2.98630136986301,219,154
"777",65,14.65,9,328,674,0.0125680614604311,2.05487804878049,2.05487804878049,1.85573469911298,84,67,172,0.422506362199783,2.17218543046358,1.37238493723849,2.96234309623431,239,151
"778",65,17.89,10,337,710,0.0125406245584287,2.10682492581602,2.10682492581602,1.78803931634139,85,73,173,0.428191840648651,2.13291139240506,1.36991869918699,2.97154471544715,246,158
"779",65,21.37,11,346,727,0.0121806148948647,2.10115606936416,2.10115606936416,1.78066165354545,87,76,182,0.440799832344055,2.12269938650307,1.34108527131783,2.89922480620155,258,163
"780",65,21.5,12,349,753,0.0123999604782136,2.15759312320917,2.15759312320917,1.78717874239867,88,78,183,0.424523204565048,2.10240963855422,1.33716475095785,2.88505747126437,261,166
"781",66,3.58,1,171,198,0.0136222910216718,1.15789473684211,1.15789473684211,2.08910640728114,39,22,58,0.452122241258621,2.80327868852459,2.1375,4.175,80,61
"782",66,4.28,2,213,342,0.0151474887058198,1.6056338028169,1.6056338028169,1.46615900740618,50,31,108,0.519993305206299,2.62962962962963,1.53237410071942,3.00719424460432,139,81
"783",66,7.52,3,249,373,0.0120805803860604,1.49799196787149,1.49799196787149,1.58396693592517,63,47,119,0.534687221050262,2.26363636363636,1.5,2.70481927710843,166,110
"784",66,8.77,4,268,463,0.0129409134104757,1.72761194029851,1.72761194029851,1.83697359692292,70,54,123,0.434990584850311,2.16129032258065,1.51412429378531,3.13559322033898,177,124
"785",66,9.34,5,283,419,0.0105004636242889,1.48056537102474,1.48056537102474,1.48470072510046,73,41,141,0.48389732837677,2.48245614035088,1.55494505494505,2.76923076923077,182,114
"786",66,12.82,6,294,583,0.0135357897425182,1.98299319727891,1.98299319727891,1.77620093058927,73,65,144,0.432479470968246,2.1304347826087,1.4066985645933,3.00478468899522,209,138
"787",66,13.6,7,304,597,0.0129624804585722,1.96381578947368,1.96381578947368,1.82327090389121,78,64,153,0.407237261533737,2.14084507042254,1.40092165898618,3.02764976958525,217,142
"788",66,13.73,8,307,554,0.0117945115071001,1.80456026058632,1.80456026058632,1.80715302928117,83,60,153,0.463499754667282,2.14685314685315,1.44131455399061,3.018779342723,213,143
"789",66,15.95,9,325,667,0.0126685660018993,2.05230769230769,2.05230769230769,1.80661465400991,80,69,163,0.429554313421249,2.18120805369128,1.40086206896552,3.04741379310345,232,149
"790",66,18.84,10,338,691,0.0121328112654294,2.04437869822485,2.04437869822485,1.7966123755909,87,69,180,0.4510797560215,2.16666666666667,1.3574297188755,2.81124497991968,249,156
"791",66,19.98,11,341,720,0.0124202173538037,2.11143695014663,2.11143695014663,1.79130168040999,86,73,181,0.431030064821243,2.14465408805031,1.34251968503937,2.85433070866142,254,159
"792",66,21.5,12,349,753,0.0123999604782136,2.15759312320917,2.15759312320917,1.78717874239867,88,78,183,0.424523204565048,2.10240963855422,1.33716475095785,2.88505747126437,261,166
"793",67,1.52,1,120,96,0.0134453781512605,0.8,0.8,1.97542677018657,26,14,35,0.477159291505814,3,2.44897959183673,5.08163265306122,49,40
"794",67,5,2,182,207,0.0125675429542833,1.13736263736264,1.13736263736264,1.94259039349575,47,26,68,0.513920962810516,2.49315068493151,1.93617021276596,3.84042553191489,94,73
"795",67,7.22,3,232,324,0.0120913569189431,1.39655172413793,1.39655172413793,1.8818618388079,65,42,99,0.523238599300385,2.16822429906542,1.64539007092199,3.04964539007092,141,107
"796",67,7.35,4,242,424,0.0145399677651658,1.75206611570248,1.75206611570248,1.83501094149891,58,44,113,0.446310967206955,2.37254901960784,1.54140127388535,3.19745222929936,157,102
"797",67,10.59,5,263,423,0.0122775955649726,1.60836501901141,1.60836501901141,1.64080095941585,70,44,126,0.484756529331207,2.30701754385965,1.54705882352941,2.97647058823529,170,114
"798",67,11.73,6,268,427,0.0119347084800716,1.59328358208955,1.59328358208955,1.581224705544,70,45,131,0.497408539056778,2.3304347826087,1.52272727272727,2.90340909090909,176,115
"799",67,12.98,7,289,552,0.0132641291810842,1.91003460207612,1.91003460207612,1.77481982318741,79,54,148,0.457527637481689,2.17293233082707,1.43069306930693,3.03465346534653,202,133
"800",67,13.76,8,300,582,0.0129765886287625,1.94,1.94,1.7317867688541,70,60,153,0.454696178436279,2.30769230769231,1.40845070422535,3.01408450704225,213,130
"801",67,14.46,9,310,597,0.0124647666771062,1.9258064516129,1.9258064516129,1.85544371332201,79,59,158,0.431744158267975,2.2463768115942,1.42857142857143,3.04608294930876,217,138
"802",67,17.35,10,326,663,0.0125153374233129,2.03374233128834,2.03374233128834,1.7977890515615,80,69,170,0.438245236873627,2.18791946308725,1.36401673640167,2.96652719665272,239,149
"803",67,20.93,11,346,741,0.0124151796933903,2.14161849710983,2.14161849710983,1.79705501369805,87,77,181,0.429842799901962,2.10975609756098,1.34108527131783,2.87209302325581,258,164
"804",67,21.5,12,349,753,0.0123999604782136,2.15759312320917,2.15759312320917,1.78717874239867,88,78,183,0.424523204565048,2.10240963855422,1.33716475095785,2.88505747126437,261,166
"805",68,0.57,1,142,86,0.00859055039456598,0.605633802816901,0.605633802816901,1.72512872095585,28,11,39,0.700175762176514,3.64102564102564,2.84,3.26,50,39
"806",68,4.05,2,185,249,0.0146298472385429,1.34594594594595,1.34594594594595,1.77809441917354,47,27,78,0.511693358421326,2.5,1.76190476190476,3.59047619047619,105,74
"807",68,4.83,3,211,260,0.0117354998871587,1.23222748815166,1.23222748815166,1.97012267319114,48,26,88,0.502566576004028,2.85135135135135,1.85087719298246,3.66666666666667,114,74
"808",68,4.96,4,220,329,0.0136571191365712,1.49545454545455,1.49545454545455,2.02027564696204,66,39,95,0.48333352804184,2.0952380952381,1.64179104477612,3.16417910447761,134,105
"809",68,6.1,5,227,277,0.0107987992670851,1.22026431718062,1.22026431718062,1.89226959174673,55,31,93,0.495067000389099,2.63953488372093,1.83064516129032,3.46774193548387,124,86
"810",68,7.35,6,252,365,0.011541137039145,1.4484126984127,1.4484126984127,1.9674694437281,62,41,104,0.467036962509155,2.44660194174757,1.73793103448276,3.57241379310345,145,103
"811",68,8.87,7,270,464,0.012777089357015,1.71851851851852,1.71851851851852,1.82659534806628,69,54,125,0.444207072257996,2.19512195121951,1.50837988826816,3.12849162011173,179,123
"812",68,12.45,8,298,611,0.0138069735385172,2.0503355704698,2.0503355704698,1.83458362165097,78,64,149,0.423569798469543,2.09859154929577,1.39906103286385,3.13615023474178,213,142
"813",68,13.15,9,306,617,0.0132219007821708,2.01633986928105,2.01633986928105,1.75445718707961,80,60,158,0.4434814453125,2.18571428571429,1.40366972477064,3.00917431192661,218,140
"814",68,16.39,10,321,601,0.0117017133956386,1.87227414330218,1.87227414330218,1.81611162241728,82,70,151,0.458747327327728,2.11184210526316,1.45248868778281,3.12669683257919,221,152
"815",68,18.61,11,337,688,0.0121520418256323,2.04154302670623,2.04154302670623,1.77926724392733,81,74,173,0.41997891664505,2.1741935483871,1.36437246963563,2.95141700404858,247,155
"816",68,21.5,12,349,753,0.0123999604782136,2.15759312320917,2.15759312320917,1.78717874239867,88,78,183,0.424523204565048,2.10240963855422,1.33716475095785,2.88505747126437,261,166
"817",69,3.24,1,156,157,0.0129859387923904,1.00641025641026,1.00641025641026,1.76486170583638,39,15,57,0.571869015693665,2.88888888888889,2.16666666666667,3.63888888888889,72,54
"818",69,4.49,2,204,247,0.0119289094948324,1.21078431372549,1.21078431372549,1.62302636816975,57,29,82,0.565531373023987,2.37209302325581,1.83783783783784,3.27927927927928,111,86
"819",69,6.71,3,239,350,0.012306177701206,1.46443514644351,1.46443514644351,1.83862126134929,55,39,101,0.402085721492767,2.54255319148936,1.70714285714286,3.49285714285714,140,94
"820",69,9.6,4,267,439,0.0123623665906339,1.64419475655431,1.64419475655431,1.90921957435651,65,49,124,0.462746679782867,2.34210526315789,1.54335260115607,3.1849710982659,173,114
"821",69,13.08,5,285,445,0.0109957993575488,1.56140350877193,1.56140350877193,1.57069519617017,67,51,140,0.508208572864532,2.41525423728814,1.49214659685864,3,191,118
"822",69,16.66,6,311,566,0.0117415205891505,1.81993569131833,1.81993569131833,1.79869472161092,82,62,148,0.485449016094208,2.15972222222222,1.48095238095238,3.04285714285714,210,144
"823",69,17.23,7,319,633,0.0124800378541433,1.98432601880878,1.98432601880878,1.83645344791621,82,64,167,0.415217280387878,2.18493150684932,1.38095238095238,2.88744588744589,231,146
"824",69,18.75,8,327,662,0.0124200296429711,2.02446483180428,2.02446483180428,1.77968749956971,82,70,168,0.448342740535736,2.15131578947368,1.37394957983193,2.92857142857143,238,152
"825",69,19.45,9,335,678,0.0121190454911073,2.02388059701493,2.02388059701493,1.77735697266573,85,72,173,0.406352996826172,2.13375796178344,1.36734693877551,2.89795918367347,245,157
"826",69,20.59,10,338,718,0.0126068863799975,2.12426035502959,2.12426035502959,1.79555435109964,86,72,177,0.421477019786835,2.13924050632911,1.3574297188755,2.92771084337349,249,158
"827",69,20.72,11,342,734,0.0125876764246883,2.14619883040936,2.14619883040936,1.79957725180982,88,76,176,0.435566306114197,2.08536585365854,1.35714285714286,2.92460317460317,252,164
"828",69,21.5,12,349,753,0.0123999604782136,2.15759312320917,2.15759312320917,1.78717874239867,88,78,183,0.424523204565048,2.10240963855422,1.33716475095785,2.88505747126437,261,166
"829",70,3.24,1,156,191,0.0157981803143093,1.22435897435897,1.22435897435897,1.84291140152229,34,20,62,0.443477421998978,2.88888888888889,1.90243902439024,3.96341463414634,82,54
"830",70,3.94,2,199,223,0.0113192223744988,1.12060301507538,1.12060301507538,1.65022741550507,54,27,79,0.522964477539062,2.45679012345679,1.87735849056604,3.28301886792453,106,81
"831",70,6.83,3,241,413,0.0142807745504841,1.71369294605809,1.71369294605809,1.87778540027499,59,40,106,0.41572031378746,2.43434343434343,1.65068493150685,3.68493150684932,146,99
"832",70,8.35,4,267,388,0.0109261918842049,1.45318352059925,1.45318352059925,1.83146304426491,58,42,125,0.497552245855331,2.67,1.59880239520958,3.20359281437126,167,100
"833",70,11.93,5,292,535,0.0125923833733465,1.83219178082192,1.83219178082192,1.86911729407447,76,62,140,0.485333174467087,2.11594202898551,1.44554455445545,2.85148514851485,202,138
"834",70,12.71,6,305,584,0.0125970664365833,1.91475409836066,1.91475409836066,1.74189955293511,78,59,157,0.396190106868744,2.22627737226277,1.41203703703704,2.98611111111111,216,137
"835",70,14.93,7,319,643,0.0126771948502593,2.01567398119122,2.01567398119122,1.81259587988757,81,60,163,0.446622163057327,2.26241134751773,1.4304932735426,3.08071748878924,223,141
"836",70,18.41,8,329,691,0.0128067314107792,2.10030395136778,2.10030395136778,1.80340215393634,85,66,170,0.429511368274689,2.17880794701987,1.39406779661017,3.02118644067797,236,151
"837",70,19.66,9,340,709,0.0123026201631095,2.08529411764706,2.08529411764706,1.8105893168964,86,74,177,0.437267363071442,2.125,1.35458167330677,2.92828685258964,251,160
"838",70,19.79,10,343,732,0.0124801800419416,2.13411078717201,2.13411078717201,1.80305752774602,88,76,177,0.424291372299194,2.09146341463415,1.35573122529644,2.90118577075099,253,164
"839",70,20.36,11,346,741,0.0124151796933903,2.14161849710983,2.14161849710983,1.77689676264475,86,77,182,0.434810131788254,2.12269938650307,1.33590733590734,2.88030888030888,259,163
"840",70,21.5,12,349,753,0.0123999604782136,2.15759312320917,2.15759312320917,1.78717874239867,88,78,183,0.424523204565048,2.10240963855422,1.33716475095785,2.88505747126437,261,166
"841",71,3.58,1,171,171,0.0117647058823529,1,1,2,44,18,65,0.490441501140594,2.75806451612903,2.06024096385542,3.6144578313253,83,62
"842",71,5.1,2,202,253,0.0124624402738781,1.25247524752475,1.25247524752475,1.87974759611929,55,28,84,0.559890031814575,2.43373493975904,1.80357142857143,3.16964285714286,112,83
"843",71,6.24,3,220,316,0.0131174761311748,1.43636363636364,1.43636363636364,1.92718601672308,56,32,94,0.500420570373535,2.5,1.74603174603175,3.64285714285714,126,88
"844",71,6.81,4,239,383,0.0134664744558911,1.60251046025105,1.60251046025105,1.96636630860932,62,38,103,0.425734043121338,2.39,1.69503546099291,3.78014184397163,141,100
"845",71,7.51,5,259,395,0.0118224536829188,1.52509652509653,1.52509652509653,1.58974131741024,64,46,115,0.485579192638397,2.35454545454545,1.60869565217391,3.06832298136646,161,110
"846",71,9.73,6,289,528,0.0126874279123414,1.82698961937716,1.82698961937716,1.87825238752677,72,58,137,0.483465731143951,2.22307692307692,1.48205128205128,3.0974358974359,195,130
"847",71,10.98,7,305,576,0.0124245038826575,1.88852459016393,1.88852459016393,1.79469531761236,81,63,156,0.46738463640213,2.11805555555556,1.39269406392694,2.81278538812785,219,144
"848",71,13.87,8,319,630,0.0124208907553085,1.97492163009404,1.97492163009404,1.81987343576411,86,62,160,0.445721805095673,2.15540540540541,1.43693693693694,3.07657657657658,222,148
"849",71,14.65,9,328,696,0.0129782949205639,2.1219512195122,2.1219512195122,1.78343982900027,79,73,172,0.445720165967941,2.15789473684211,1.33877551020408,2.9469387755102,245,152
"850",71,14.78,10,331,679,0.0124324819188868,2.05135951661631,2.05135951661631,1.79375860934167,83,72,169,0.409865915775299,2.13548387096774,1.37344398340249,2.98340248962656,241,155
"851",71,18.02,11,340,731,0.0126843657817109,2.15,2.15,1.78865138701835,85,75,177,0.432890862226486,2.125,1.34920634920635,2.9484126984127,252,160
"852",71,21.5,12,349,753,0.0123999604782136,2.15759312320917,2.15759312320917,1.78717874239867,88,78,183,0.424523204565048,2.10240963855422,1.33716475095785,2.88505747126437,261,166
"853",72,0.7,1,144,134,0.013014763014763,0.930555555555556,0.930555555555556,1.7593904566997,29,14,53,0.486940264701843,3.34883720930233,2.14925373134328,3.94029850746269,67,43
"854",72,4.28,2,213,311,0.0137744707237134,1.46009389671362,1.46009389671362,1.8332319546721,51,30,104,0.462226390838623,2.62962962962963,1.58955223880597,3.37313432835821,134,81
"855",72,5.06,3,238,336,0.0119136262099777,1.41176470588235,1.41176470588235,1.63947580613243,61,39,112,0.498476445674896,2.38,1.57615894039735,2.9205298013245,151,100
"856",72,5.19,4,249,410,0.0132789221401736,1.64658634538153,1.64658634538153,1.82964870159438,65,42,110,0.447046369314194,2.32710280373832,1.63815789473684,3.40131578947368,152,107
"857",72,6.71,5,268,377,0.010537201632288,1.40671641791045,1.40671641791045,1.59649686069859,73,46,123,0.515904486179352,2.25210084033613,1.58579881656805,2.77514792899408,169,119
"858",72,7.28,6,275,488,0.0129528865295289,1.77454545454545,1.77454545454545,1.838370214801,68,44,137,0.448846101760864,2.45535714285714,1.51933701657459,3.1878453038674,181,112
"859",72,10.17,7,297,514,0.0116935116935117,1.73063973063973,1.73063973063973,1.81124985551515,80,54,142,0.47251284122467,2.21641791044776,1.51530612244898,3.13265306122449,196,134
"860",72,12.39,8,314,620,0.012616755865774,1.97452229299363,1.97452229299363,1.81360810241273,83,60,158,0.425754398107529,2.1958041958042,1.44036697247706,3.11009174311927,218,143
"861",72,13.53,9,319,648,0.0127757733483173,2.03134796238245,2.03134796238245,1.83276788779934,82,67,163,0.415826022624969,2.14093959731544,1.38695652173913,3,230,149
"862",72,14.78,10,331,644,0.011791632335439,1.94561933534743,1.94561933534743,1.84732751990147,86,70,164,0.43767836689949,2.12179487179487,1.41452991452991,2.94871794871795,234,156
"863",72,18.02,11,340,696,0.0120770432066632,2.04705882352941,2.04705882352941,1.83306044130316,86,73,171,0.444338172674179,2.13836477987421,1.39344262295082,2.95901639344262,244,159
"864",72,21.5,12,349,753,0.0123999604782136,2.15759312320917,2.15759312320917,1.78717874239867,88,78,183,0.424523204565048,2.10240963855422,1.33716475095785,2.88505747126437,261,166
"865",73,2.22,1,171,204,0.0140350877192982,1.19298245614035,1.19298245614035,1.79163280191166,43,26,71,0.491962164640427,2.47826086956522,1.76288659793814,3.17525773195876,97,69
"866",73,5.46,2,206,280,0.0132607151314232,1.35922330097087,1.35922330097087,2.03304666587971,48,31,80,0.483826547861099,2.60759493670886,1.85585585585586,3.51351351351351,111,79
"867",73,6.6,3,215,358,0.0155618343838296,1.66511627906977,1.66511627906977,1.91587140146816,53,33,95,0.407536447048187,2.5,1.6796875,3.5625,128,86
"868",73,7.85,4,246,415,0.013771362203418,1.6869918699187,1.6869918699187,1.95645555641829,64,42,108,0.415427505970001,2.32075471698113,1.64,3.62,150,106
"869",73,8.42,5,259,433,0.0129598036574781,1.67181467181467,1.67181467181467,1.96244776600467,75,46,121,0.479596167802811,2.1404958677686,1.55089820359281,3.13173652694611,167,121
"870",73,11.9,6,274,462,0.0123526108927569,1.68613138686131,1.68613138686131,1.80581793722082,70,52,126,0.465421855449677,2.24590163934426,1.53932584269663,3.25842696629213,178,122
"871",73,12.6,7,287,482,0.0117443532077678,1.6794425087108,1.6794425087108,1.89622089975016,76,58,135,0.509359776973724,2.14179104477612,1.48704663212435,2.81865284974093,193,134
"872",73,15.49,8,305,534,0.011518550474547,1.75081967213115,1.75081967213115,1.81891724510694,79,61,146,0.475701034069061,2.17857142857143,1.47342995169082,2.90821256038647,207,140
"873",73,16.27,9,314,592,0.0120469668911907,1.88535031847134,1.88535031847134,1.77058214318027,81,61,163,0.443359315395355,2.2112676056338,1.40178571428571,2.86607142857143,224,142
"874",73,16.4,10,317,599,0.0119594297807771,1.88958990536278,1.88958990536278,1.8436533343662,77,68,156,0.454825937747955,2.18620689655172,1.41517857142857,3.06696428571429,224,145
"875",73,17.92,11,329,644,0.0119356512714063,1.95744680851064,1.95744680851064,1.83274304683078,85,68,167,0.463732272386551,2.15032679738562,1.4,2.94468085106383,235,153
"876",73,21.5,12,349,753,0.0123999604782136,2.15759312320917,2.15759312320917,1.78717874239867,88,78,183,0.424523204565048,2.10240963855422,1.33716475095785,2.88505747126437,261,166
"877",74,3.48,1,144,109,0.0105866355866356,0.756944444444444,0.756944444444444,2.32392016862409,31,14,41,0.538001894950867,3.2,2.61818181818182,5.2,55,45
"878",74,5.7,2,211,284,0.0128187767998195,1.34597156398104,1.34597156398104,1.92497284308725,53,28,91,0.456897258758545,2.60493827160494,1.77310924369748,3.35294117647059,119,81
"879",74,6.48,3,233,399,0.0147624685511322,1.71244635193133,1.71244635193133,1.91453842873634,58,41,101,0.433565080165863,2.35353535353535,1.64084507042254,3.78169014084507,142,99
"880",74,6.61,4,240,370,0.0129009762900976,1.54166666666667,1.54166666666667,1.81613059361023,69,37,105,0.461544930934906,2.26415094339623,1.69014084507042,3.57746478873239,142,106
"881",74,7.75,5,247,374,0.0123103255324051,1.51417004048583,1.51417004048583,1.96587635862833,60,35,100,0.433891475200653,2.6,1.82962962962963,3.81481481481481,135,95
"882",74,8.32,6,256,430,0.0131740196078431,1.6796875,1.6796875,1.93786154101521,75,46,115,0.499118447303772,2.11570247933884,1.59006211180124,3.01863354037267,161,121
"883",74,11.56,7,275,445,0.0118115461181155,1.61818181818182,1.61818181818182,1.94453167498389,76,49,122,0.509713411331177,2.2,1.60818713450292,3.2046783625731,171,125
"884",74,14.45,8,297,591,0.0134452634452634,1.98989898989899,1.98989898989899,1.89905560014293,78,59,144,0.428819477558136,2.16788321167883,1.46305418719212,3.12315270935961,203,137
"885",74,15.7,9,311,609,0.0126335442381496,1.95819935691318,1.95819935691318,1.77625094134556,73,66,158,0.437544673681259,2.23741007194245,1.38839285714286,2.95982142857143,224,139
"886",74,17.22,10,323,657,0.0126338865065477,2.03405572755418,2.03405572755418,1.81829232562624,81,72,163,0.450292944908142,2.11111111111111,1.37446808510638,2.98297872340426,235,153
"887",74,17.92,11,329,676,0.0125287271109793,2.05471124620061,2.05471124620061,1.79163239002571,82,67,172,0.407745659351349,2.20805369127517,1.3765690376569,2.98326359832636,239,149
"888",74,21.5,12,349,753,0.0123999604782136,2.15759312320917,2.15759312320917,1.78717874239867,88,78,183,0.424523204565048,2.10240963855422,1.33716475095785,2.88505747126437,261,166
"889",75,0.57,1,142,90,0.00899011087803416,0.633802816901408,0.633802816901408,2.03671922443779,30,7,43,0.57265430688858,3.83783783783784,2.84,3.7,50,37
"890",75,1.27,2,184,229,0.0136018056545498,1.2445652173913,1.2445652173913,2.05581589570584,49,25,68,0.517019093036652,2.48648648648649,1.97849462365591,3.56989247311828,93,74
"891",75,4.75,3,212,245,0.0109541267996065,1.15566037735849,1.15566037735849,1.80278466535213,53,22,83,0.447721809148788,2.82666666666667,2.01904761904762,3.59047619047619,105,75
"892",75,5.53,4,233,279,0.0103226283853781,1.19742489270386,1.19742489270386,1.60125862141051,61,33,99,0.580105721950531,2.47872340425532,1.76515151515152,3.08333333333333,132,94
"893",75,5.66,5,240,377,0.0131450488145049,1.57083333333333,1.57083333333333,1.97776879415644,57,42,104,0.42303466796875,2.42424242424242,1.64383561643836,3.32876712328767,146,99
"894",75,7.88,6,268,486,0.0135837665604561,1.8134328358209,1.8134328358209,1.83006350662631,64,54,132,0.413635313510895,2.27118644067797,1.44086021505376,3.19354838709677,186,118
"895",75,9.13,7,285,520,0.0128490239683716,1.82456140350877,1.82456140350877,1.86578387569119,67,57,143,0.484175324440002,2.29838709677419,1.425,2.97,200,124
"896",75,10.65,8,299,470,0.0105497070772822,1.57190635451505,1.57190635451505,1.63617964581287,74,52,146,0.486749708652496,2.37301587301587,1.51010101010101,2.70707070707071,198,126
"897",75,11.79,9,303,546,0.0119336436954954,1.8019801980198,1.8019801980198,1.79172796269997,77,59,146,0.463197201490402,2.22794117647059,1.4780487804878,3.03414634146341,205,136
"898",75,15.37,10,327,676,0.0126826888801336,2.06727828746177,2.06727828746177,1.82662586468035,82,66,170,0.452223986387253,2.20945945945946,1.38559322033898,2.98305084745763,236,148
"899",75,18.26,11,340,700,0.0121464515009544,2.05882352941176,2.05882352941176,1.78078764130996,84,74,177,0.420872449874878,2.15189873417722,1.35458167330677,2.8804780876494,251,158
"900",75,21.5,12,349,753,0.0123999604782136,2.15759312320917,2.15759312320917,1.78717874239867,88,78,183,0.424523204565048,2.10240963855422,1.33716475095785,2.88505747126437,261,166
"901",76,3.48,1,144,139,0.0135003885003885,0.965277777777778,0.965277777777778,1.8516345030129,32,16,55,0.548315227031708,3,2.02816901408451,3.90140845070423,71,48
"902",76,6.72,2,198,203,0.0104086550787058,1.02525252525253,1.02525252525253,2.13384470151511,46,28,66,0.511854231357574,2.67567567567568,2.1063829787234,3.91489361702128,94,74
"903",76,7.29,3,220,320,0.0132835201328352,1.45454545454545,1.45454545454545,1.50720065824061,53,35,103,0.475302755832672,2.5,1.59420289855072,2.90579710144928,138,88
"904",76,8.54,4,245,357,0.011943793911007,1.45714285714286,1.45714285714286,1.63610010146606,64,37,114,0.509152770042419,2.42574257425743,1.62251655629139,3.13245033112583,151,101
"905",76,8.67,5,253,488,0.0153083631344501,1.92885375494071,1.92885375494071,1.93121585510521,69,49,119,0.405265271663666,2.14406779661017,1.50595238095238,3.33928571428571,168,118
"906",76,10.19,6,273,522,0.0140594699418229,1.91208791208791,1.91208791208791,1.89626825232101,71,48,134,0.435130178928375,2.29411764705882,1.5,3.20879120879121,182,119
"907",76,10.89,7,286,509,0.0124892651208441,1.77972027972028,1.77972027972028,1.89484432536718,70,60,136,0.392884820699692,2.2,1.45918367346939,2.99489795918367,196,130
"908",76,13.78,8,306,545,0.0116789885353048,1.78104575163399,1.78104575163399,1.74863158301689,77,57,151,0.465814292430878,2.28358208955224,1.47115384615385,3.11057692307692,208,134
"909",76,16,9,318,627,0.0124397357300161,1.97169811320755,1.97169811320755,1.88755263002532,89,64,155,0.450455129146576,2.07843137254902,1.45205479452055,3.03196347031963,219,153
"910",76,17.14,10,321,644,0.0125389408099688,2.00623052959502,2.00623052959502,1.72081352492228,80,66,166,0.448803573846817,2.1986301369863,1.38362068965517,2.91810344827586,232,146
"911",76,20.72,11,342,741,0.0127077223851417,2.16666666666667,2.16666666666667,1.79180664879068,87,75,178,0.420875072479248,2.11111111111111,1.35177865612648,2.93280632411067,253,162
"912",76,21.5,12,349,753,0.0123999604782136,2.15759312320917,2.15759312320917,1.78717874239867,88,78,183,0.424523204565048,2.10240963855422,1.33716475095785,2.88505747126437,261,166
"913",77,2.22,1,171,182,0.0125214998280014,1.06432748538012,1.06432748538012,1.50862823155769,42,27,65,0.56717187166214,2.47826086956522,1.85869565217391,3.25,92,69
"914",77,2.35,2,195,293,0.0154903515728258,1.5025641025641,1.5025641025641,2.00044195837025,47,32,84,0.381210029125214,2.46835443037975,1.68103448275862,3.51724137931034,116,79
"915",77,5.83,3,222,295,0.0120256002608944,1.32882882882883,1.32882882882883,1.79188269983791,52,29,102,0.471399128437042,2.74074074074074,1.69465648854962,3.19083969465649,131,81
"916",77,6.61,4,240,379,0.0132147838214784,1.57916666666667,1.57916666666667,1.97146396336076,56,33,117,0.462761342525482,2.69662921348315,1.6,3.16,150,89
"917",77,9.85,5,262,391,0.011435757947998,1.49236641221374,1.49236641221374,1.93988862101264,63,47,123,0.477753937244415,2.38181818181818,1.54117647058824,3.03529411764706,170,110
"918",77,13.43,6,294,570,0.0132339625269903,1.93877551020408,1.93877551020408,1.78900658534617,76,63,146,0.44818252325058,2.11510791366906,1.4066985645933,3.07655502392344,209,139
"919",77,16.32,7,313,656,0.0134349143933808,2.09584664536741,2.09584664536741,1.82750918649428,76,62,164,0.450515449047089,2.26811594202899,1.38495575221239,3.02212389380531,226,138
"920",77,16.89,8,320,621,0.0121669278996865,1.940625,1.940625,1.52553322002979,81,65,168,0.436259329319,2.19178082191781,1.37339055793991,2.75107296137339,233,146
"921",77,17.59,9,328,661,0.0123256507794436,2.01524390243902,2.01524390243902,1.80462818916686,84,71,167,0.410008907318115,2.11612903225806,1.3781512605042,2.90756302521008,238,155
"922",77,18.84,10,338,722,0.0126771197303039,2.13609467455621,2.13609467455621,1.81897609582314,86,73,177,0.415430963039398,2.12578616352201,1.352,2.944,250,159
"923",77,19.98,11,341,724,0.0124892185613248,2.12316715542522,2.12316715542522,1.77242022447104,83,76,175,0.433767467737198,2.14465408805031,1.35856573705179,2.93625498007968,251,159
"924",77,21.5,12,349,753,0.0123999604782136,2.15759312320917,2.15759312320917,1.78717874239867,88,78,183,0.424523204565048,2.10240963855422,1.33716475095785,2.88505747126437,261,166
"925",78,1.25,1,132,106,0.0122600046264168,0.803030303030303,0.803030303030303,1.73016936781432,27,14,47,0.579343199729919,3.21951219512195,2.16393442622951,3.36065573770492,61,41
"926",78,4.14,2,200,257,0.0129145728643216,1.285,1.285,2.06761953812644,52,25,81,0.498115062713623,2.5974025974026,1.88679245283019,3.4622641509434,106,77
"927",78,4.27,3,219,295,0.0123580914079846,1.34703196347032,1.34703196347032,1.62118407327182,48,28,101,0.495403647422791,2.88157894736842,1.69767441860465,3.2093023255814,129,76
"928",78,5.05,4,242,347,0.0118994547512088,1.43388429752066,1.43388429752066,1.67936187245273,62,36,109,0.486749351024628,2.46938775510204,1.66896551724138,3.02068965517241,145,98
"929",78,8.29,5,269,416,0.0115408089663208,1.54646840148699,1.54646840148699,1.54637834590878,67,52,123,0.536797344684601,2.26050420168067,1.53714285714286,2.84,175,119
"930",78,11.77,6,287,565,0.0137667210837943,1.96864111498258,1.96864111498258,1.93700238923574,74,63,135,0.443281412124634,2.09489051094891,1.44949494949495,3.10606060606061,198,137
"931",78,12.91,7,293,491,0.0114778624526626,1.67576791808874,1.67576791808874,1.87024827653773,71,60,132,0.484959423542023,2.23664122137405,1.52604166666667,3.00520833333333,192,131
"932",78,13.61,8,300,568,0.0126644370122631,1.89333333333333,1.89333333333333,1.60428174316169,78,63,149,0.514013290405273,2.12765957446809,1.41509433962264,2.89622641509434,212,141
"933",78,14.18,9,304,565,0.0122676741358346,1.85855263157895,1.85855263157895,1.79570676568671,75,60,151,0.449328809976578,2.25185185185185,1.44075829383886,3.11374407582938,211,135
"934",78,15.7,10,318,636,0.0126182965299685,2,2,1.84963121910496,81,68,165,0.425655663013458,2.13422818791946,1.36480686695279,2.91416309012876,233,149
"935",78,17.92,11,329,642,0.011898584031433,1.95136778115502,1.95136778115502,1.80501008924346,82,66,171,0.423711180686951,2.22297297297297,1.38818565400844,2.9493670886076,237,148
"936",78,21.5,12,349,753,0.0123999604782136,2.15759312320917,2.15759312320917,1.78717874239867,88,78,183,0.424523204565048,2.10240963855422,1.33716475095785,2.88505747126437,261,166
"937",79,1.52,1,120,88,0.0123249299719888,0.733333333333333,0.733333333333333,2.29636296496563,28,11,34,0.561337828636169,3.07692307692308,2.66666666666667,4.53333333333333,45,39
"938",79,4.41,2,211,215,0.00970435567591966,1.01895734597156,1.01895734597156,1.67526359877191,44,23,92,0.54777717590332,3.14925373134328,1.83478260869565,3.17391304347826,115,67
"939",79,5.11,3,238,405,0.0143601744495266,1.70168067226891,1.70168067226891,1.87387234773991,55,37,106,0.41258043050766,2.58695652173913,1.66433566433566,3.89510489510489,143,92
"940",79,8.59,4,256,465,0.0142463235294118,1.81640625,1.81640625,1.88718606726662,70,48,127,0.464853763580322,2.16949152542373,1.46285714285714,3.14285714285714,175,118
"941",79,12.17,5,282,504,0.0127205269932611,1.78723404255319,1.78723404255319,1.84978761951105,64,53,139,0.448385119438171,2.41025641025641,1.46875,3.234375,192,117
"942",79,13.42,6,296,535,0.0122537792029317,1.80743243243243,1.80743243243243,1.89316982816254,72,58,146,0.420939803123474,2.27692307692308,1.45098039215686,2.92156862745098,204,130
"943",79,15.64,7,319,616,0.012144870960746,1.93103448275862,1.93103448275862,1.8408884188646,80,67,154,0.451946973800659,2.17006802721088,1.44343891402715,3.05429864253394,221,147
"944",79,16.21,8,324,622,0.011887016014983,1.91975308641975,1.91975308641975,1.83535834523078,84,65,163,0.44085568189621,2.1744966442953,1.42105263157895,3.00877192982456,228,149
"945",79,16.34,9,328,663,0.0123629447303647,2.02134146341463,2.02134146341463,1.77487672585917,83,75,164,0.467336177825928,2.07594936708861,1.37238493723849,3.02510460251046,239,158
"946",79,17.48,10,332,700,0.0127397808757689,2.10843373493976,2.10843373493976,1.78836621038526,84,74,171,0.44487452507019,2.10126582278481,1.35510204081633,2.95918367346939,245,158
"947",79,20.72,11,342,732,0.0125533775788445,2.14035087719298,2.14035087719298,1.77563033302685,85,73,179,0.430451989173889,2.16455696202532,1.35714285714286,2.95238095238095,252,158
"948",79,21.5,12,349,753,0.0123999604782136,2.15759312320917,2.15759312320917,1.78717874239867,88,78,183,0.424523204565048,2.10240963855422,1.33716475095785,2.88505747126437,261,166
"949",80,2.89,1,163,182,0.0137847458910854,1.11656441717791,1.11656441717791,2.10483532434317,38,24,54,0.483818382024765,2.62903225806452,2.08974358974359,4.51282051282051,78,62
"950",80,3.02,2,192,233,0.012707242582897,1.21354166666667,1.21354166666667,2.01867921645511,47,21,77,0.436432778835297,2.82352941176471,1.95918367346939,4.16326530612245,98,68
"951",80,4.16,3,208,245,0.0113805276848755,1.17788461538462,1.17788461538462,1.63146441991684,46,27,90,0.520508110523224,2.84931506849315,1.77777777777778,3.25641025641026,117,73
"952",80,6.38,4,245,403,0.0134827701572432,1.64489795918367,1.64489795918367,1.8379296756974,61,40,115,0.434504836797714,2.42574257425743,1.58064516129032,3.38064516129032,155,101
"953",80,7.63,5,268,454,0.0126893621778747,1.69402985074627,1.69402985074627,1.88304618688626,73,45,136,0.438243538141251,2.27118644067797,1.48066298342541,2.98342541436464,181,118
"954",80,9.15,6,287,511,0.0124509636704759,1.78048780487805,1.78048780487805,1.84944243546736,70,53,138,0.46763950586319,2.33333333333333,1.50261780104712,3.2303664921466,191,123
"955",80,12.39,7,299,565,0.0126820946780095,1.88963210702341,1.88963210702341,1.76673919541657,71,59,153,0.423033893108368,2.3,1.41037735849057,2.9622641509434,212,130
"956",80,13.17,8,309,532,0.0111797587525743,1.72168284789644,1.72168284789644,1.83317424727449,80,57,150,0.472267389297485,2.25547445255474,1.49275362318841,2.96618357487923,207,137
"957",80,16.65,9,320,651,0.0127547021943574,2.034375,2.034375,1.79727243425792,80,69,166,0.419810235500336,2.14765100671141,1.36170212765957,3.00425531914894,235,149
"958",80,17.22,10,323,633,0.0121723746706921,1.95975232198142,1.95975232198142,1.76223348131859,74,67,169,0.42358785867691,2.29078014184397,1.36864406779661,2.97457627118644,236,141
"959",80,20.8,11,343,731,0.0124631306156548,2.13119533527697,2.13119533527697,1.79215112640198,86,76,179,0.40091809630394,2.11728395061728,1.34509803921569,2.90196078431373,255,162
"960",80,21.5,12,349,753,0.0123999604782136,2.15759312320917,2.15759312320917,1.78717874239867,88,78,183,0.424523204565048,2.10240963855422,1.33716475095785,2.88505747126437,261,166
"961",81,0.13,1,110,76,0.0126772310258549,0.690909090909091,0.690909090909091,1.81545879045432,16,10,36,0.555488228797913,4.23076923076923,2.39130434782609,4.56521739130435,46,26
"962",81,1.65,2,167,149,0.0107495851670154,0.892215568862275,0.892215568862275,1.56598930716844,40,17,69,0.673370599746704,2.92982456140351,1.94186046511628,2.91860465116279,86,57
"963",81,3.87,3,222,295,0.0120256002608944,1.32882882882883,1.32882882882883,1.64577852034001,61,31,89,0.535731077194214,2.41304347826087,1.85,3.55833333333333,120,92
"964",81,7.45,4,266,439,0.0124556674705632,1.65037593984962,1.65037593984962,1.74047354655455,60,47,129,0.449411302804947,2.48598130841122,1.51136363636364,3.40340909090909,176,107
"965",81,10.93,5,279,482,0.0124287666640881,1.72759856630824,1.72759856630824,1.94637944722652,72,51,128,0.451393306255341,2.26829268292683,1.55865921787709,3.10055865921788,179,123
"966",81,13.82,6,302,540,0.0118809267122836,1.78807947019868,1.78807947019868,1.61576253201177,73,61,150,0.483595699071884,2.25373134328358,1.43127962085308,2.91469194312796,211,134
"967",81,14.52,7,310,616,0.012861467794133,1.98709677419355,1.98709677419355,1.85710707322305,77,64,156,0.407132863998413,2.19858156028369,1.40909090909091,2.91818181818182,220,141
"968",81,15.77,8,323,619,0.0119031594331096,1.91640866873065,1.91640866873065,1.8598804835289,84,70,152,0.445306330919266,2.0974025974026,1.45495495495495,3.1036036036036,222,154
"969",81,16.55,9,333,698,0.0126270849162415,2.0960960960961,2.0960960960961,1.78677302530484,80,72,174,0.438390284776688,2.19078947368421,1.35365853658537,2.98373983739837,246,152
"970",81,19.79,10,343,727,0.0123949329105076,2.11953352769679,2.11953352769679,1.77233076019796,84,75,181,0.428412675857544,2.15723270440252,1.33984375,2.91015625,256,159
"971",81,20.36,11,346,742,0.0124319343218564,2.14450867052023,2.14450867052023,1.79651345647532,87,78,181,0.419819504022598,2.0969696969697,1.33590733590734,2.86872586872587,259,165
"972",81,21.5,12,349,753,0.0123999604782136,2.15759312320917,2.15759312320917,1.78717874239867,88,78,183,0.424523204565048,2.10240963855422,1.33716475095785,2.88505747126437,261,166
"973",82,3.58,1,171,199,0.0136910904712762,1.16374269005848,1.16374269005848,2.05198171656167,45,25,65,0.491237640380859,2.44285714285714,1.9,3.9,90,70
"974",82,5.8,2,237,366,0.0130873203175284,1.54430379746835,1.54430379746835,1.56629751720363,60,43,108,0.47477525472641,2.30097087378641,1.56953642384106,3.11920529801325,151,103
"975",82,9.28,3,258,421,0.0126986999668205,1.63178294573643,1.63178294573643,1.89369504371715,61,44,117,0.446801245212555,2.45714285714286,1.60248447204969,3.49068322981366,161,105
"976",82,9.41,4,266,447,0.0126826500212796,1.68045112781955,1.68045112781955,1.89730408536286,63,52,125,0.452872484922409,2.31304347826087,1.50282485875706,3.15254237288136,177,115
"977",82,10.19,5,278,476,0.0123626730384645,1.71223021582734,1.71223021582734,1.94779069451153,69,52,125,0.458267837762833,2.29752066115702,1.57062146892655,3.42937853107345,177,121
"978",82,13.43,6,294,567,0.0131643100926377,1.92857142857143,1.92857142857143,1.89259441076409,76,67,135,0.463412433862686,2.05594405594406,1.45544554455446,3.0990099009901,202,143
"979",82,14,7,302,594,0.0130690193835119,1.96688741721854,1.96688741721854,1.80875966600957,76,59,154,0.412807941436768,2.23703703703704,1.41784037558685,3.07981220657277,213,135
"980",82,16.89,8,320,648,0.0126959247648903,2.025,2.025,1.84893147955204,83,67,165,0.459107398986816,2.13333333333333,1.37931034482759,2.94827586206897,232,150
"981",82,18.41,9,328,700,0.0130528828224062,2.13414634146341,2.13414634146341,1.82750711708517,81,74,169,0.40364283323288,2.11612903225806,1.34979423868313,2.94650205761317,243,155
"982",82,19.66,10,340,689,0.0119555786916537,2.02647058823529,2.02647058823529,1.78441983304221,87,73,174,0.420865118503571,2.125,1.37651821862348,2.95951417004049,247,160
"983",82,20.8,11,343,711,0.0121221420899187,2.07288629737609,2.07288629737609,1.77677312688932,84,75,178,0.430223494768143,2.15723270440252,1.35573122529644,2.90909090909091,253,159
"984",82,21.5,12,349,753,0.0123999604782136,2.15759312320917,2.15759312320917,1.78717874239867,88,78,183,0.424523204565048,2.10240963855422,1.33716475095785,2.88505747126437,261,166
"985",83,3.24,1,156,128,0.0105872622001654,0.82051282051282,0.82051282051282,1.71514100567704,30,17,54,0.572906494140625,3.31914893617021,2.19718309859155,3.43661971830986,71,47
"986",83,6.82,2,223,379,0.0153112754009615,1.69955156950673,1.69955156950673,1.82719252350936,58,34,109,0.399722248315811,2.42391304347826,1.55944055944056,3.43356643356643,143,92
"987",83,7.39,3,244,405,0.0136612021857923,1.65983606557377,1.65983606557377,1.92729928874371,69,42,111,0.42998930811882,2.1981981981982,1.59477124183007,3.35294117647059,153,111
"988",83,9.61,4,273,464,0.0124973066149537,1.6996336996337,1.6996336996337,1.927546137889,65,49,126,0.426594078540802,2.39473684210526,1.56,3.14285714285714,175,114
"989",83,13.09,5,286,511,0.0125383388541283,1.78671328671329,1.78671328671329,1.86070385235218,73,55,137,0.456866681575775,2.234375,1.48958333333333,3.15104166666667,192,128
"990",83,14.34,6,303,561,0.0122614910497672,1.85148514851485,1.85148514851485,1.81125832445266,76,58,149,0.435898810625076,2.26119402985075,1.46376811594203,3.07729468599034,207,134
"991",83,14.47,7,309,644,0.0135333921741689,2.08414239482201,2.08414239482201,1.86269196514086,83,59,162,0.420119047164917,2.17605633802817,1.39819004524887,3.01809954751131,221,142
"992",83,15.99,8,318,582,0.0115469317302542,1.83018867924528,1.83018867924528,1.77961875066419,79,68,156,0.471293687820435,2.16326530612245,1.41964285714286,2.97767857142857,224,147
"993",83,16.77,9,326,650,0.0122699386503067,1.99386503067485,1.99386503067485,1.58990010249468,85,70,169,0.453742057085037,2.10322580645161,1.36401673640167,2.79497907949791,239,155
"994",83,17.47,10,334,727,0.0130729531927137,2.17664670658683,2.17664670658683,1.78459523356634,83,77,173,0.418548494577408,2.0875,1.336,2.956,250,160
"995",83,18.61,11,337,716,0.0126466016673732,2.12462908011869,2.12462908011869,1.79423852349457,86,73,178,0.446935176849365,2.11949685534591,1.34262948207171,2.86852589641434,251,159
"996",83,21.5,12,349,753,0.0123999604782136,2.15759312320917,2.15759312320917,1.78717874239867,88,78,183,0.424523204565048,2.10240963855422,1.33716475095785,2.88505747126437,261,166
"997",84,3.48,1,144,111,0.0107808857808858,0.770833333333333,0.770833333333333,1.85835765750915,36,10,45,0.588507413864136,3.1304347826087,2.61818181818182,4.21818181818182,55,46
"998",84,4.26,2,185,163,0.00957696827262045,0.881081081081081,0.881081081081081,2.17123354103164,46,25,62,0.583047866821289,2.6056338028169,2.1264367816092,3.27586206896552,87,71
"999",84,5.78,3,213,283,0.0125343254495527,1.32863849765258,1.32863849765258,2.11053435435302,53,28,87,0.477768421173096,2.62962962962963,1.85217391304348,3.56521739130435,115,81
"1000",84,8,4,251,358,0.0114103585657371,1.42629482071713,1.42629482071713,1.83011038375519,72,45,105,0.54738461971283,2.14529914529915,1.67333333333333,3.15333333333333,150,117
"1001",84,8.13,5,258,481,0.0145084909359636,1.86434108527132,1.86434108527132,1.8025014504299,64,50,124,0.43110117316246,2.26315789473684,1.48275862068966,3.21264367816092,174,114
"1002",84,9.38,6,283,463,0.0116031376087011,1.63604240282686,1.63604240282686,1.83062459909217,70,43,133,0.477095544338226,2.50442477876106,1.60795454545455,3.16477272727273,176,113
"1003",84,12.96,7,310,607,0.0126735567386992,1.95806451612903,1.95806451612903,1.83758928174333,82,61,152,0.46152251958847,2.16783216783217,1.45539906103286,3.14553990610329,213,143
"1004",84,13.66,8,318,613,0.0121619744856457,1.92767295597484,1.92767295597484,1.80818451586353,79,66,155,0.418070703744888,2.19310344827586,1.43891402714932,3.0316742081448,221,145
"1005",84,14.8,9,322,664,0.0128480486058706,2.06211180124224,2.06211180124224,1.80207256806625,76,72,166,0.43197375535965,2.17567567567568,1.35294117647059,2.9453781512605,238,148
"1006",84,15.37,10,327,678,0.0127202116282997,2.07339449541284,2.07339449541284,1.85380160027739,87,67,167,0.423755198717117,2.12337662337662,1.3974358974359,2.97863247863248,234,154
"1007",84,18.61,11,337,715,0.0126289388158824,2.12166172106825,2.12166172106825,1.79587310597036,84,73,172,0.416295170783997,2.14649681528662,1.37551020408163,2.97551020408163,245,157
"1008",84,21.5,12,349,753,0.0123999604782136,2.15759312320917,2.15759312320917,1.78717874239867,88,78,183,0.424523204565048,2.10240963855422,1.33716475095785,2.88505747126437,261,166
"1009",85,1.52,1,120,85,0.0119047619047619,0.708333333333333,0.708333333333333,1.49133170385992,22,11,40,0.615155696868896,3.63636363636364,2.35294117647059,4.37254901960784,51,33
"1010",85,5.1,2,202,196,0.00965469681296488,0.97029702970297,0.97029702970297,1.57901502574756,44,31,79,0.614574611186981,2.69333333333333,1.83636363636364,2.93636363636364,110,75
"1011",85,8.58,3,232,328,0.0122406329302881,1.41379310344828,1.41379310344828,1.9458669060404,58,39,102,0.443341940641403,2.39175257731959,1.64539007092199,3.20567375886525,141,97
"1012",85,9.28,4,253,415,0.0130183825836,1.6403162055336,1.6403162055336,1.939389905593,61,44,118,0.41536071896553,2.40952380952381,1.56172839506173,3.31481481481481,162,105
"1013",85,11.5,5,285,508,0.01255250803064,1.78245614035088,1.78245614035088,1.9061645351953,75,59,130,0.497706025838852,2.12686567164179,1.50793650793651,3.18518518518519,189,134
"1014",85,14.74,6,300,589,0.0131326644370123,1.96333333333333,1.96333333333333,1.89769158699595,77,67,142,0.430086374282837,2.08333333333333,1.43540669856459,3.11004784688995,209,144
"1015",85,14.87,7,306,536,0.0114861245044466,1.7516339869281,1.7516339869281,1.65174380541305,77,53,158,0.465655624866486,2.35384615384615,1.45023696682464,2.80094786729858,211,130
"1016",85,16.12,8,320,638,0.0125,1.99375,1.99375,1.82643196830638,79,66,162,0.457368195056915,2.20689655172414,1.40350877192982,3.02631578947368,228,145
"1017",85,19.01,9,334,719,0.0129290967614321,2.15269461077844,2.15269461077844,1.7959264823884,84,74,176,0.431058615446091,2.11392405063291,1.336,2.928,250,158
"1018",85,20.15,10,337,720,0.0127172530733362,2.13649851632047,2.13649851632047,1.79718812450788,89,73,175,0.424074977636337,2.08024691358025,1.35887096774194,2.93145161290323,248,162
"1019",85,20.72,11,342,723,0.0123990327725472,2.1140350877193,2.1140350877193,1.77704475355098,87,72,182,0.443856209516525,2.15094339622642,1.34645669291339,2.87007874015748,254,159
"1020",85,21.5,12,349,753,0.0123999604782136,2.15759312320917,2.15759312320917,1.78717874239867,88,78,183,0.424523204565048,2.10240963855422,1.33716475095785,2.88505747126437,261,166
"1021",86,0.57,1,142,178,0.0177804415143342,1.25352112676056,1.25352112676056,1.758182221691,37,13,57,0.431889951229095,2.84,2.02857142857143,4.41428571428571,70,50
"1022",86,4.05,2,185,152,0.00893066980023502,0.821621621621622,0.821621621621622,1.44432277852646,41,21,74,0.67501300573349,2.98387096774194,1.94736842105263,3.15789473684211,95,62
"1023",86,5.3,3,216,330,0.0142118863049096,1.52777777777778,1.52777777777778,1.54625473625739,47,34,107,0.472773224115372,2.66666666666667,1.53191489361702,3.26950354609929,141,81
"1024",86,5.43,4,229,282,0.0108021144564468,1.23144104803493,1.23144104803493,1.72324823755351,51,36,94,0.535146594047546,2.63218390804598,1.76153846153846,3.15384615384615,130,87
"1025",86,8.67,5,253,344,0.0107911412259238,1.3596837944664,1.3596837944664,1.47840363387551,65,46,114,0.536155521869659,2.27927927927928,1.58125,2.75625,160,111
"1026",86,9.37,6,266,443,0.0125691587459214,1.66541353383459,1.66541353383459,1.90709562944832,69,47,119,0.444784432649612,2.29310344827586,1.60240963855422,3.24096385542169,166,116
"1027",86,10.51,7,269,496,0.0137601953059979,1.84386617100372,1.84386617100372,1.79428731757214,66,53,131,0.445991307497025,2.26050420168067,1.46195652173913,3.05978260869565,184,119
"1028",86,12.03,8,289,545,0.0130959246443676,1.88581314878893,1.88581314878893,1.90303635853539,78,55,139,0.44044440984726,2.17293233082707,1.48969072164948,3.06701030927835,194,133
"1029",86,12.81,9,299,561,0.0125923099369262,1.87625418060201,1.87625418060201,1.7650996061094,77,62,146,0.4512679874897,2.15107913669065,1.4375,3.02884615384615,208,139
"1030",86,15.03,10,315,579,0.0117076129814983,1.83809523809524,1.83809523809524,1.58606335456241,77,60,166,0.472084254026413,2.2992700729927,1.39380530973451,2.80088495575221,226,137
"1031",86,17.92,11,329,642,0.011898584031433,1.95136778115502,1.95136778115502,1.7956708274508,84,70,159,0.457109302282333,2.13636363636364,1.43668122270742,3,229,154
"1032",86,21.5,12,349,753,0.0123999604782136,2.15759312320917,2.15759312320917,1.78717874239867,88,78,183,0.424523204565048,2.10240963855422,1.33716475095785,2.88505747126437,261,166
"1033",87,3.24,1,156,111,0.00918114143920595,0.711538461538462,0.711538461538462,1.69710403777603,29,14,52,0.60177743434906,3.62790697674419,2.36363636363636,3.22727272727273,66,43
"1034",87,4.38,2,175,212,0.0139244663382594,1.21142857142857,1.21142857142857,1.70138197764087,48,22,73,0.541295886039734,2.5,1.84210526315789,3.37894736842105,95,70
"1035",87,5.63,3,214,331,0.0145232767320434,1.54672897196262,1.54672897196262,2.03344119112442,57,33,94,0.459219098091125,2.37777777777778,1.68503937007874,3.58267716535433,127,90
"1036",87,8.52,4,252,465,0.0147030923923354,1.8452380952381,1.8452380952381,1.85568058094955,73,40,119,0.425367146730423,2.23008849557522,1.58490566037736,3.50314465408805,159,113
"1037",87,12.1,5,287,516,0.0125727930605979,1.79790940766551,1.79790940766551,1.82059486291837,69,56,142,0.456077963113785,2.296,1.44949494949495,3.10606060606061,198,125
"1038",87,15.58,6,301,541,0.0119822812846069,1.79734219269103,1.79734219269103,1.76896353416957,81,60,150,0.478133171796799,2.13475177304965,1.43333333333333,2.8,210,141
"1039",87,16.28,7,309,605,0.012713823393435,1.957928802589,1.957928802589,1.79456700329782,81,62,156,0.44817703962326,2.16083916083916,1.41743119266055,3.06880733944954,218,143
"1040",87,17.06,8,322,676,0.0130802422553743,2.09937888198758,2.09937888198758,1.83364396239225,86,66,165,0.435450673103333,2.11842105263158,1.39393939393939,3.01731601731602,231,152
"1041",87,18.58,9,332,694,0.0126305827539766,2.09036144578313,2.09036144578313,1.8348366189843,85,73,168,0.44643771648407,2.10126582278481,1.37759336099585,2.94605809128631,241,158
"1042",87,20.8,10,343,709,0.0120880432373451,2.06705539358601,2.06705539358601,1.77953306455348,84,75,179,0.438473880290985,2.15723270440252,1.3503937007874,2.88188976377953,254,159
"1043",87,20.93,11,346,737,0.0123481611795258,2.13005780346821,2.13005780346821,1.79885065005161,87,76,179,0.452553421258926,2.12269938650307,1.35686274509804,2.92156862745098,255,163
"1044",87,21.5,12,349,753,0.0123999604782136,2.15759312320917,2.15759312320917,1.78717874239867,88,78,183,0.424523204565048,2.10240963855422,1.33716475095785,2.88505747126437,261,166
"1045",88,2.89,1,163,154,0.0116640157539953,0.94478527607362,0.94478527607362,1.57893357023711,40,17,60,0.609419763088226,2.85964912280702,2.11688311688312,3.22077922077922,77,57
"1046",88,3.59,2,200,265,0.0133165829145729,1.325,1.325,1.64367074409505,49,28,88,0.509056627750397,2.5974025974026,1.72413793103448,3.45689655172414,116,77
"1047",88,4.84,3,222,231,0.00941665647548001,1.04054054054054,1.04054054054054,1.95296045721331,50,31,78,0.55340039730072,2.74074074074074,2.03669724770642,3.46788990825688,109,81
"1048",88,8.08,4,257,406,0.0123419260700389,1.57976653696498,1.57976653696498,1.94808759893509,68,49,116,0.499056577682495,2.1965811965812,1.55757575757576,3.1030303030303,165,117
"1049",88,9.22,5,263,423,0.0122775955649726,1.60836501901141,1.60836501901141,1.88830722942617,65,50,128,0.455881953239441,2.28695652173913,1.47752808988764,2.97191011235955,178,115
"1050",88,10.74,6,286,573,0.0140596245859404,2.0034965034965,2.0034965034965,1.88271344132481,77,61,135,0.443172842264175,2.07246376811594,1.45918367346939,3.22959183673469,196,138
"1051",88,14.22,7,298,540,0.012202562538133,1.81208053691275,1.81208053691275,1.791920998507,75,60,152,0.477930426597595,2.20740740740741,1.40566037735849,3.02358490566038,212,135
"1052",88,17.8,8,319,643,0.0126771948502593,2.01567398119122,2.01567398119122,1.83719515386705,80,60,166,0.44445988535881,2.27857142857143,1.41150442477876,3.00442477876106,226,140
"1053",88,18.37,9,326,660,0.0124587069372345,2.02453987730061,2.02453987730061,1.80454173394092,83,67,167,0.418169170618057,2.17333333333333,1.39316239316239,2.94017094017094,234,150
"1054",88,18.5,10,330,643,0.0118448926959565,1.94848484848485,1.94848484848485,1.82804845781896,85,69,171,0.455736994743347,2.14285714285714,1.375,2.84166666666667,240,154
"1055",88,20.72,11,342,713,0.012227538543328,2.08479532163743,2.08479532163743,1.78465909985783,87,72,175,0.442442417144775,2.15094339622642,1.38461538461538,2.97975708502024,247,159
"1056",88,21.5,12,349,753,0.0123999604782136,2.15759312320917,2.15759312320917,1.78717874239867,88,78,183,0.424523204565048,2.10240963855422,1.33716475095785,2.88505747126437,261,166
"1057",89,3.48,1,144,113,0.010975135975136,0.784722222222222,0.784722222222222,1.87726413805314,35,14,46,0.605372428894043,2.93877551020408,2.4,3.3,60,49
"1058",89,4.62,2,165,191,0.0141167775314117,1.15757575757576,1.15757575757576,1.73025294186797,38,23,58,0.520695686340332,2.70491803278689,2.03703703703704,4.01234567901235,81,61
"1059",89,8.2,3,228,353,0.0136409305201329,1.54824561403509,1.54824561403509,1.95348450212394,63,34,93,0.410764873027802,2.35051546391753,1.79527559055118,3.76377952755906,127,97
"1060",89,8.33,4,239,337,0.0118490911008755,1.41004184100418,1.41004184100418,1.95675546212851,63,39,104,0.526292383670807,2.34313725490196,1.67132867132867,3.44755244755245,143,102
"1061",89,11.22,5,272,480,0.0130236596483612,1.76470588235294,1.76470588235294,1.9316360195899,72,53,128,0.461781710386276,2.176,1.50276243093923,3.27624309392265,181,125
"1062",89,14.46,6,293,559,0.0130674645845996,1.90784982935154,1.90784982935154,1.82101649689383,71,56,139,0.450977832078934,2.30708661417323,1.5025641025641,3.3025641025641,195,127
"1063",89,16.68,7,309,601,0.0126297650569495,1.94498381877023,1.94498381877023,1.83750868133957,74,56,158,0.434996008872986,2.37692307692308,1.44392523364486,3.1214953271028,214,130
"1064",89,17.38,8,317,620,0.0123787086211716,1.95583596214511,1.95583596214511,1.78265689448983,81,63,161,0.438281774520874,2.20138888888889,1.41517857142857,3.09821428571429,224,144
"1065",89,18.16,9,326,659,0.0124398301085418,2.02147239263804,2.02147239263804,1.79453733744169,79,69,171,0.440335869789124,2.2027027027027,1.35833333333333,2.90416666666667,240,148
"1066",89,19.68,10,335,696,0.0124407900616677,2.07761194029851,2.07761194029851,1.76593461820922,83,69,173,0.450172007083893,2.20394736842105,1.38429752066116,2.99586776859504,242,152
"1067",89,20.93,11,346,747,0.012515707464187,2.15895953757225,2.15895953757225,1.78439845684137,87,77,182,0.422273635864258,2.10975609756098,1.33590733590734,2.8996138996139,259,164
"1068",89,21.5,12,349,753,0.0123999604782136,2.15759312320917,2.15759312320917,1.78717874239867,88,78,183,0.424523204565048,2.10240963855422,1.33716475095785,2.88505747126437,261,166
"1069",90,0.57,1,142,140,0.0139846169213865,0.985915492957746,0.985915492957746,2.18439047129294,33,15,43,0.460433632135391,2.95833333333333,2.44827586206897,5.03448275862069,58,48
"1070",90,2.79,2,204,303,0.0146334395827296,1.48529411764706,1.48529411764706,1.67932057885076,50,29,89,0.465989232063293,2.58227848101266,1.72881355932203,3.30508474576271,118,79
"1071",90,3.49,3,227,320,0.0124751471677517,1.40969162995595,1.40969162995595,1.98235553728811,55,32,93,0.435087889432907,2.60919540229885,1.816,3.736,125,87
"1072",90,4.27,4,242,352,0.012070916635232,1.45454545454545,1.45454545454545,1.9606145302174,69,38,106,0.497978329658508,2.26168224299065,1.68055555555556,3.26388888888889,144,107
"1073",90,5.52,5,264,348,0.0100241963359834,1.31818181818182,1.31818181818182,1.60503811577693,63,36,121,0.542356133460999,2.66666666666667,1.68152866242038,3.06369426751592,157,99
"1074",90,5.65,6,268,413,0.0115434065626922,1.5410447761194,1.5410447761194,1.91798167611204,77,45,118,0.504485011100769,2.19672131147541,1.6441717791411,3.25153374233129,163,122
"1075",90,7.17,7,283,489,0.0122547176903992,1.72791519434629,1.72791519434629,1.83725246540178,75,49,139,0.437278538942337,2.28225806451613,1.50531914893617,3.21276595744681,188,124
"1076",90,10.41,8,298,559,0.012631911960771,1.8758389261745,1.8758389261745,1.8410916206052,79,61,141,0.418379068374634,2.12857142857143,1.47524752475248,3.07920792079208,202,140
"1077",90,13.89,9,312,631,0.0130060186330283,2.0224358974359,2.0224358974359,1.86253428533155,79,65,162,0.429647773504257,2.16666666666667,1.37444933920705,2.90748898678414,227,144
"1078",90,17.47,10,334,697,0.0125334915754077,2.08682634730539,2.08682634730539,1.79730739365314,84,71,169,0.449882566928864,2.15483870967742,1.39166666666667,3.0125,240,155
"1079",90,20.36,11,346,750,0.0125659713495853,2.16763005780347,2.16763005780347,1.78592087109423,88,78,180,0.422004491090775,2.08433734939759,1.34108527131783,2.90697674418605,258,166
"1080",90,21.5,12,349,753,0.0123999604782136,2.15759312320917,2.15759312320917,1.78717874239867,88,78,183,0.424523204565048,2.10240963855422,1.33716475095785,2.88505747126437,261,166
"1081",91,2.89,1,163,154,0.0116640157539953,0.94478527607362,0.94478527607362,2.03442913441859,34,16,53,0.507484376430511,3.26,2.36231884057971,4.8695652173913,69,50
"1082",91,3.67,2,201,241,0.0119900497512438,1.19900497512438,1.19900497512438,1.83678698715555,54,27,81,0.57666015625,2.48148148148148,1.86111111111111,3.26851851851852,108,81
"1083",91,4.24,3,227,314,0.0122412381583564,1.38325991189427,1.38325991189427,2.01034231411796,52,37,98,0.454181671142578,2.55056179775281,1.68148148148148,3.45185185185185,135,89
"1084",91,4.37,4,237,365,0.0130515626117428,1.54008438818565,1.54008438818565,1.98648129334103,60,40,108,0.424969017505646,2.37,1.60135135135135,3.37162162162162,148,100
"1085",91,7.85,5,253,433,0.0135830353221658,1.71146245059289,1.71146245059289,1.94971572182056,65,45,126,0.474734485149384,2.3,1.47953216374269,3.05263157894737,171,110
"1086",91,11.09,6,277,451,0.0117982524982996,1.62815884476534,1.62815884476534,1.64534917024445,70,52,130,0.470418065786362,2.27049180327869,1.52197802197802,3.01098901098901,182,122
"1087",91,12.61,7,291,504,0.0119445431923214,1.7319587628866,1.7319587628866,1.82869905340662,70,53,143,0.464618355035782,2.36585365853659,1.48469387755102,3.03571428571429,196,123
"1088",91,16.19,8,315,609,0.0123142250530786,1.93333333333333,1.93333333333333,1.85522940381472,79,62,152,0.434558510780334,2.23404255319149,1.47196261682243,3.02803738317757,214,141
"1089",91,18.41,9,328,696,0.0129782949205639,2.1219512195122,2.1219512195122,1.81739072773699,84,73,167,0.412013649940491,2.08917197452229,1.36666666666667,2.94583333333333,240,157
"1090",91,19.66,10,340,714,0.0123893805309735,2.1,2.1,1.7818542350822,86,74,177,0.428977519273758,2.125,1.35458167330677,2.87649402390438,251,160
"1091",91,20.8,11,343,735,0.012531328320802,2.14285714285714,2.14285714285714,1.79466395557784,88,76,179,0.444437026977539,2.09146341463415,1.34509803921569,2.91372549019608,255,164
"1092",91,21.5,12,349,753,0.0123999604782136,2.15759312320917,2.15759312320917,1.78717874239867,88,78,183,0.424523204565048,2.10240963855422,1.33716475095785,2.88505747126437,261,166
"1093",92,0.78,1,137,129,0.013847144697295,0.941605839416058,0.941605839416058,2.37741390511796,36,18,42,0.488342016935349,2.53703703703704,2.28333333333333,4.33333333333333,60,54
"1094",92,1.35,2,185,209,0.0122796709753231,1.12972972972973,1.12972972972973,1.76175892397839,35,22,72,0.452210366725922,3.24561403508772,1.96808510638298,4.47872340425532,94,57
"1095",92,2.05,3,210,315,0.0143540669856459,1.5,1.5,1.93707496924357,45,38,91,0.439879059791565,2.53012048192771,1.62790697674419,3.68992248062015,129,83
"1096",92,3.19,4,216,290,0.012489233419466,1.34259259259259,1.34259259259259,1.93071231130772,51,34,95,0.462520778179169,2.54117647058824,1.67441860465116,3.2015503875969,129,85
"1097",92,6.67,5,238,343,0.0121618267560189,1.44117647058824,1.44117647058824,1.90089069157978,62,38,97,0.48514649271965,2.38,1.76296296296296,3.77777777777778,135,100
"1098",92,8.89,6,267,449,0.0126439694742474,1.68164794007491,1.68164794007491,1.66203670820265,71,51,125,0.470253169536591,2.18852459016393,1.51704545454545,3.02840909090909,176,122
"1099",92,12.47,7,299,510,0.0114475544881147,1.7056856187291,1.7056856187291,1.58936954132344,73,51,152,0.497237592935562,2.41129032258065,1.47290640394089,2.97536945812808,203,124
"1100",92,13.72,8,314,570,0.011599275554018,1.81528662420382,1.81528662420382,1.86650240569089,79,65,158,0.454987704753876,2.18055555555556,1.40807174887892,2.85201793721973,223,144
"1101",92,16.61,9,328,644,0.0120086521966137,1.96341463414634,1.96341463414634,1.55638629670343,83,70,169,0.478346467018127,2.1437908496732,1.37238493723849,2.8326359832636,239,153
"1102",92,19.85,10,338,709,0.0124488613418082,2.09763313609467,2.09763313609467,1.78974919325199,85,74,178,0.412888079881668,2.12578616352201,1.34126984126984,2.83730158730159,252,159
"1103",92,21.37,11,346,750,0.0125659713495853,2.16763005780347,2.16763005780347,1.78557541698083,87,76,183,0.422505795955658,2.12269938650307,1.33590733590734,2.8996138996139,259,163
"1104",92,21.5,12,349,753,0.0123999604782136,2.15759312320917,2.15759312320917,1.78717874239867,88,78,183,0.424523204565048,2.10240963855422,1.33716475095785,2.88505747126437,261,166
"1105",93,1.25,1,132,179,0.0207032153597039,1.35606060606061,1.35606060606061,1.99863105584977,35,15,51,0.414047658443451,2.64,2,4.51515151515152,66,50
"1106",93,2.03,2,187,220,0.0126502213788741,1.17647058823529,1.17647058823529,1.8140505973904,45,23,70,0.546518623828888,2.75,2.01075268817204,3.63440860215054,93,68
"1107",93,3.17,3,204,270,0.0130396986380759,1.32352941176471,1.32352941176471,1.87086087563519,52,23,88,0.455823063850403,2.72,1.83783783783784,3.6036036036036,111,75
"1108",93,3.74,4,225,266,0.0105555555555556,1.18222222222222,1.18222222222222,1.98817471038173,55,33,90,0.536908507347107,2.55681818181818,1.82926829268293,3.60162601626016,123,88
"1109",93,4.44,5,240,328,0.0114365411436541,1.36666666666667,1.36666666666667,1.58943091605899,56,37,101,0.512901544570923,2.58064516129032,1.73913043478261,3.45652173913043,138,93
"1110",93,8.02,6,278,467,0.0121289250188297,1.67985611510791,1.67985611510791,1.65325639238044,66,52,135,0.438130766153336,2.35593220338983,1.48663101604278,2.93582887700535,187,118
"1111",93,8.15,7,283,459,0.0115028945192091,1.62190812720848,1.62190812720848,1.8374415948508,72,49,140,0.482210099697113,2.33884297520661,1.4973544973545,2.94708994708995,189,121
"1112",93,11.04,8,304,586,0.0127236407851311,1.92763157894737,1.92763157894737,1.82318279419324,73,61,156,0.434526085853577,2.26865671641791,1.40092165898618,2.96774193548387,217,134
"1113",93,14.28,9,319,629,0.0124011750556969,1.9717868338558,1.9717868338558,1.80379752982814,79,68,160,0.438566744327545,2.17006802721088,1.39912280701754,2.96052631578947,228,147
"1114",93,15.8,10,328,679,0.012661296337734,2.07012195121951,2.07012195121951,1.78748546721916,81,68,170,0.436103314161301,2.20134228187919,1.3781512605042,2.99579831932773,238,149
"1115",93,18.02,11,340,729,0.0126496616345653,2.14411764705882,2.14411764705882,1.81888563355896,89,74,174,0.435351192951202,2.08588957055215,1.37096774193548,2.94354838709677,248,163
"1116",93,21.5,12,349,753,0.0123999604782136,2.15759312320917,2.15759312320917,1.78717874239867,88,78,183,0.424523204565048,2.10240963855422,1.33716475095785,2.88505747126437,261,166
"1117",94,3.58,1,171,164,0.0112831097351221,0.95906432748538,0.95906432748538,1.64418558030613,42,22,55,0.541511714458466,2.671875,2.22077922077922,3.49350649350649,77,64
"1118",94,7.06,2,214,233,0.010223333772103,1.08878504672897,1.08878504672897,1.75455117423477,50,22,88,0.508417963981628,2.97222222222222,1.94545454545455,3.39090909090909,110,72
"1119",94,8.31,3,239,364,0.0127984248092542,1.52301255230126,1.52301255230126,1.92024551465246,65,39,97,0.459885567426682,2.29807692307692,1.75735294117647,3.77205882352941,136,104
"1120",94,8.88,4,258,442,0.0133321268060206,1.71317829457364,1.71317829457364,1.79958608131514,68,46,124,0.477787613868713,2.26315789473684,1.51764705882353,3.25294117647059,170,114
"1121",94,10.02,5,264,401,0.0115508699158889,1.51893939393939,1.51893939393939,1.53724084558011,68,44,122,0.496731966733932,2.35714285714286,1.59036144578313,2.96385542168675,166,112
"1122",94,12.24,6,294,515,0.0119570012305263,1.75170068027211,1.75170068027211,1.94377512354069,80,57,138,0.460518449544907,2.14598540145985,1.50769230769231,3.12820512820513,195,137
"1123",94,13.76,7,304,586,0.0127236407851311,1.92763157894737,1.92763157894737,1.79371454247402,80,63,151,0.451965093612671,2.12587412587413,1.42056074766355,3.12616822429907,214,143
"1124",94,14.54,8,315,594,0.0120109190172884,1.88571428571429,1.88571428571429,1.88654414132787,85,61,161,0.461720168590546,2.15753424657534,1.41891891891892,2.92342342342342,222,146
"1125",94,14.67,9,319,640,0.0126180477514245,2.00626959247649,2.00626959247649,1.77482989575175,83,61,159,0.402933359146118,2.21527777777778,1.45,3.12727272727273,220,144
"1126",94,17.56,10,334,697,0.0125334915754077,2.08682634730539,2.08682634730539,1.77491488978621,82,72,172,0.436776578426361,2.16883116883117,1.36885245901639,2.96311475409836,244,154
"1127",94,18.26,11,340,713,0.0123720284574007,2.09705882352941,2.09705882352941,1.80029585118236,88,76,172,0.444347530603409,2.07317073170732,1.37096774193548,2.95564516129032,248,164
"1128",94,21.5,12,349,753,0.0123999604782136,2.15759312320917,2.15759312320917,1.78717874239867,88,78,183,0.424523204565048,2.10240963855422,1.33716475095785,2.88505747126437,261,166
"1129",95,0.7,1,144,139,0.0135003885003885,0.965277777777778,0.965277777777778,1.84351016673294,32,19,47,0.533124566078186,2.82352941176471,2.18181818181818,4.24242424242424,66,51
"1130",95,1.84,2,163,182,0.0137847458910854,1.11656441717791,1.11656441717791,2.00607249287536,39,15,61,0.471938788890839,3.01851851851852,2.14473684210526,4.64473684210526,76,54
"1131",95,5.08,3,207,197,0.00923971671122368,0.951690821256039,0.951690821256039,2.05968405730501,41,24,80,0.538212716579437,3.18461538461538,1.99038461538462,3.90384615384615,104,65
"1132",95,8.56,4,233,344,0.0127275418084949,1.47639484978541,1.47639484978541,2.00262820415622,57,40,94,0.426708787679672,2.4020618556701,1.73880597014925,3.64925373134328,134,97
"1133",95,12.14,5,272,439,0.011911222053397,1.61397058823529,1.61397058823529,1.47338176795764,67,46,140,0.528694331645966,2.4070796460177,1.46236559139785,2.7741935483871,186,113
"1134",95,12.92,6,287,533,0.012987012987013,1.85714285714286,1.85714285714286,1.83270157175213,82,59,137,0.44488525390625,2.0354609929078,1.46428571428571,2.96428571428571,196,141
"1135",95,13.49,7,293,533,0.0124596755341531,1.81911262798635,1.81911262798635,1.78228292958568,70,56,143,0.42370879650116,2.32539682539683,1.47236180904523,3.1105527638191,199,126
"1136",95,14.74,8,307,549,0.0116880628472888,1.78827361563518,1.78827361563518,1.83894739099166,74,61,149,0.452233076095581,2.27407407407407,1.46190476190476,3.07142857142857,210,135
"1137",95,17.63,9,326,670,0.0126474752241623,2.05521472392638,2.05521472392638,1.82915129826843,83,70,166,0.406831115484238,2.13071895424837,1.38135593220339,2.96186440677966,236,153
"1138",95,19.85,10,338,715,0.0125542113672677,2.11538461538462,2.11538461538462,1.79788018275176,86,72,178,0.426118642091751,2.13924050632911,1.352,2.92,250,158
"1139",95,21.37,11,346,746,0.0124989528357209,2.15606936416185,2.15606936416185,1.79120199493868,87,75,182,0.426580756902695,2.1358024691358,1.34630350194553,2.91439688715953,257,162
"1140",95,21.5,12,349,753,0.0123999604782136,2.15759312320917,2.15759312320917,1.78717874239867,88,78,183,0.424523204565048,2.10240963855422,1.33716475095785,2.88505747126437,261,166
"1141",96,0.7,1,144,122,0.0118492618492618,0.847222222222222,0.847222222222222,1.92571148770928,33,14,51,0.502922654151917,3.06382978723404,2.21538461538462,3.58461538461538,65,47
"1142",96,2.92,2,204,260,0.0125567468366657,1.27450980392157,1.27450980392157,2.08146108583458,54,24,76,0.46885359287262,2.61538461538462,2.04,3.95,100,78
"1143",96,5.81,3,241,374,0.0129322268326418,1.55186721991701,1.55186721991701,1.72285230543552,61,42,107,0.485068887472153,2.33980582524272,1.61744966442953,3.11409395973154,149,103
"1144",96,7.06,4,261,448,0.0132036545829649,1.71647509578544,1.71647509578544,1.76302010205129,62,44,125,0.462870746850967,2.4622641509434,1.54437869822485,3.44970414201183,169,106
"1145",96,10.3,5,277,487,0.0127400198817559,1.75812274368231,1.75812274368231,1.88794693205061,71,53,133,0.460351049900055,2.23387096774194,1.48924731182796,3.05913978494624,186,124
"1146",96,13.78,6,294,473,0.0109818671495902,1.60884353741497,1.60884353741497,1.51818678331861,75,51,148,0.461037695407867,2.33333333333333,1.47738693467337,2.85929648241206,199,126
"1147",96,14.56,7,305,569,0.0122735116479724,1.8655737704918,1.8655737704918,1.81606616997607,77,64,144,0.402715295553207,2.16312056737589,1.46634615384615,3.1875,208,141
"1148",96,15.7,8,310,578,0.0120680655600793,1.86451612903226,1.86451612903226,1.58371989047477,75,63,158,0.448453187942505,2.2463768115942,1.4027149321267,2.8552036199095,221,138
"1149",96,15.83,9,313,610,0.0124928319816499,1.94888178913738,1.94888178913738,1.76442113951456,78,58,163,0.452413350343704,2.30147058823529,1.41628959276018,3.06334841628959,221,136
"1150",96,16.4,10,317,625,0.0124785369165036,1.97160883280757,1.97160883280757,1.8694042373258,81,69,160,0.428170204162598,2.11333333333333,1.38427947598253,2.91703056768559,229,150
"1151",96,19.98,11,341,733,0.0126444712782474,2.14956011730205,2.14956011730205,1.80799372399927,87,76,178,0.418863981962204,2.0920245398773,1.34251968503937,2.92125984251969,254,163
"1152",96,21.5,12,349,753,0.0123999604782136,2.15759312320917,2.15759312320917,1.78717874239867,88,78,183,0.424523204565048,2.10240963855422,1.33716475095785,2.88505747126437,261,166
"1153",97,1.52,1,120,94,0.0131652661064426,0.783333333333333,0.783333333333333,1.65650460820217,27,10,42,0.631847023963928,3.24324324324324,2.30769230769231,3.48076923076923,52,37
"1154",97,2.66,2,164,139,0.0103995211731258,0.847560975609756,0.847560975609756,1.64586542170159,35,26,57,0.625588774681091,2.68852459016393,1.97590361445783,2.95180722891566,83,61
"1155",97,2.79,3,187,180,0.0103501811281697,0.962566844919786,0.962566844919786,1.70117442507582,45,17,78,0.553857922554016,3.01612903225806,1.96842105263158,3.16842105263158,95,62
"1156",97,5.01,4,230,356,0.0135181317638124,1.54782608695652,1.54782608695652,1.71464322828125,56,31,110,0.452602237462997,2.64367816091954,1.63120567375887,3.19858156028369,141,87
"1157",97,6.26,5,260,396,0.0117612117612118,1.52307692307692,1.52307692307692,1.60455275522075,60,42,128,0.444925963878632,2.54901960784314,1.52941176470588,3.07647058823529,170,102
"1158",97,9.74,6,275,410,0.0108825481088255,1.49090909090909,1.49090909090909,1.62118369762894,69,47,122,0.483036875724792,2.37068965517241,1.62721893491124,3,169,116
"1159",97,10.52,7,287,492,0.011988011988012,1.71428571428571,1.71428571428571,1.87427789772959,75,52,136,0.440548777580261,2.25984251968504,1.52659574468085,3.13829787234043,188,127
"1160",97,11.09,8,293,539,0.0125999345457946,1.83959044368601,1.83959044368601,1.80724867162396,72,61,147,0.450760900974274,2.20300751879699,1.40865384615385,3.09615384615385,208,133
"1161",97,13.98,9,312,627,0.0129235716052436,2.00961538461538,2.00961538461538,1.79813299805366,79,68,153,0.445300400257111,2.12244897959184,1.41176470588235,3.07239819004525,221,147
"1162",97,17.22,10,323,644,0.0123839009287926,1.9938080495356,1.9938080495356,1.77875267719058,77,66,164,0.408766031265259,2.25874125874126,1.40434782608696,3,230,143
"1163",97,20.8,11,343,740,0.012616575452236,2.15743440233236,2.15743440233236,1.79544229761193,87,76,179,0.418026864528656,2.10429447852761,1.34509803921569,2.91372549019608,255,163
"1164",97,21.5,12,349,753,0.0123999604782136,2.15759312320917,2.15759312320917,1.78717874239867,88,78,183,0.424523204565048,2.10240963855422,1.33716475095785,2.88505747126437,261,166
"1165",98,3.58,1,171,211,0.0145166838665291,1.23391812865497,1.23391812865497,1.87569981998565,45,23,72,0.498551279306412,2.51470588235294,1.8,3.83157894736842,95,68
"1166",98,4.83,2,211,277,0.0125028210336267,1.31279620853081,1.31279620853081,1.7076246586717,52,28,89,0.504333436489105,2.6375,1.8034188034188,3.25641025641026,117,80
"1167",98,5.97,3,228,318,0.0122884303269186,1.39473684210526,1.39473684210526,1.97387122294158,57,36,91,0.442288666963577,2.45161290322581,1.79527559055118,3.65354330708661,127,93
"1168",98,9.21,4,259,378,0.011313639220616,1.45945945945946,1.45945945945946,1.72240435689285,62,48,107,0.51196426153183,2.35454545454545,1.67096774193548,3.04516129032258,155,110
"1169",98,9.78,5,272,469,0.0127252007814196,1.72426470588235,1.72426470588235,1.87160644152842,70,51,129,0.44890233874321,2.24793388429752,1.51111111111111,3.29444444444444,180,121
"1170",98,12,6,296,547,0.0125286303252405,1.84797297297297,1.84797297297297,1.90504790463816,67,58,144,0.444057434797287,2.368,1.46534653465347,3.06930693069307,202,125
"1171",98,12.78,7,306,566,0.0121290046073074,1.84967320261438,1.84967320261438,1.83693305072316,74,62,153,0.435905694961548,2.25,1.42325581395349,3,215,136
"1172",98,12.91,8,311,582,0.0120734363655222,1.87138263665595,1.87138263665595,1.80341848854571,72,64,158,0.394638419151306,2.28676470588235,1.4009009009009,2.98648648648649,222,136
"1173",98,14.43,9,320,648,0.0126959247648903,2.025,2.025,1.81807765644493,81,65,162,0.441408038139343,2.19178082191781,1.40969162995595,3.05286343612335,227,146
"1174",98,17.91,10,329,665,0.0123248572911261,2.02127659574468,2.02127659574468,1.80477075736956,85,67,167,0.438304036855698,2.16447368421053,1.40598290598291,2.96581196581197,234,152
"1175",98,18.61,11,337,709,0.012522961706938,2.10385756676558,2.10385756676558,1.81873133690354,86,72,175,0.410206496715546,2.13291139240506,1.36437246963563,2.89473684210526,247,158
"1176",98,21.5,12,349,753,0.0123999604782136,2.15759312320917,2.15759312320917,1.78717874239867,88,78,183,0.424523204565048,2.10240963855422,1.33716475095785,2.88505747126437,261,166
"1177",99,1.14,1,114,66,0.0102468560782487,0.578947368421053,0.578947368421053,2.02810646338203,18,8,32,0.584595918655396,4.38461538461539,2.85,4.125,40,26
"1178",99,4.38,2,175,150,0.00985221674876847,0.857142857142857,0.857142857142857,1.55579500072831,39,21,67,0.635288894176483,2.91666666666667,1.98863636363636,3.21590909090909,88,60
"1179",99,7.96,3,233,335,0.0123945537960633,1.43776824034335,1.43776824034335,1.9953065391611,66,31,88,0.451837837696075,2.4020618556701,1.95798319327731,4.15966386554622,119,97
"1180",99,8.09,4,247,393,0.0129357164016984,1.59109311740891,1.59109311740891,1.96951088494578,57,39,118,0.469171047210693,2.57291666666667,1.57324840764331,3.21019108280255,157,96
"1181",99,10.98,5,280,554,0.0141833077316948,1.97857142857143,1.97857142857143,1.84349781567977,71,51,140,0.428170889616013,2.29508196721311,1.46596858638743,3.28795811518325,191,122
"1182",99,14.46,6,293,494,0.0115479919584833,1.68600682593857,1.68600682593857,1.88812174261212,75,51,140,0.430108666419983,2.32539682539683,1.53403141361257,3.1151832460733,191,126
"1183",99,16.68,7,309,612,0.0128609254822847,1.98058252427184,1.98058252427184,1.80764799148047,75,61,161,0.429833352565765,2.27205882352941,1.39189189189189,3.03603603603604,222,136
"1184",99,17.25,8,316,565,0.0113522202129797,1.7879746835443,1.7879746835443,1.86558321242551,86,63,156,0.457846343517303,2.12080536912752,1.44292237442922,2.85844748858448,219,149
"1185",99,18.03,9,323,638,0.0122685229698287,1.97523219814241,1.97523219814241,1.86032481693759,80,69,161,0.396747022867203,2.16778523489933,1.40434782608696,2.96086956521739,230,149
"1186",99,18.73,10,331,662,0.0121212121212121,2,2,1.79772583611022,80,69,167,0.453538447618484,2.22147651006711,1.40254237288136,3.03389830508475,236,149
"1187",99,20.25,11,339,712,0.012427780977815,2.10029498525074,2.10029498525074,1.84084991693303,85,75,175,0.438682556152344,2.11875,1.356,2.88,250,160
"1188",99,21.5,12,349,753,0.0123999604782136,2.15759312320917,2.15759312320917,1.78717874239867,88,78,183,0.424523204565048,2.10240963855422,1.33716475095785,2.88505747126437,261,166
"1189",100,0.7,1,144,123,0.0119463869463869,0.854166666666667,0.854166666666667,2.1177919207246,27,15,40,0.507204711437225,3.42857142857143,2.61818181818182,4.90909090909091,55,42
"1190",100,2.92,2,204,238,0.0114942528735632,1.16666666666667,1.16666666666667,2.05630994163163,49,24,75,0.519975602626801,2.79452054794521,2.06060606060606,3.28282828282828,99,73
"1191",100,3.49,3,227,322,0.0125531168375502,1.41850220264317,1.41850220264317,1.63473440605625,50,35,103,0.515118062496185,2.67058823529412,1.64492753623188,3.05072463768116,138,85
"1192",100,6.97,4,248,405,0.0132231944625833,1.63306451612903,1.63306451612903,1.75790478541436,60,42,113,0.446389257907867,2.43137254901961,1.6,3.36774193548387,155,102
"1193",100,10.55,5,284,507,0.0126163340466829,1.78521126760563,1.78521126760563,1.59826495270813,79,51,139,0.461264193058014,2.18461538461538,1.49473684210526,3.06315789473684,190,130
"1194",100,10.68,6,289,521,0.0125192233756248,1.80276816608997,1.80276816608997,1.86676534265415,79,53,138,0.458228468894958,2.18939393939394,1.5130890052356,3.17801047120419,191,132
"1195",100,11.46,7,299,540,0.0121209400462391,1.80602006688963,1.80602006688963,1.9273826984885,71,63,138,0.453492850065231,2.23134328358209,1.48756218905473,3.00995024875622,201,134
"1196",100,12.6,8,303,557,0.0121740650886281,1.83828382838284,1.83828382838284,1.80828551984221,73,59,147,0.442667007446289,2.29545454545455,1.47087378640777,3.0873786407767,206,132
"1197",100,14.12,9,313,624,0.012779552715655,1.99361022364217,1.99361022364217,1.80185005289808,81,63,160,0.40967983007431,2.17361111111111,1.40358744394619,3.08968609865471,223,144
"1198",100,15.37,10,327,681,0.0127764957505488,2.08256880733945,2.08256880733945,1.84956495362102,86,70,168,0.392933040857315,2.09615384615385,1.37394957983193,2.95798319327731,238,156
"1199",100,18.61,11,337,692,0.0122226932315953,2.05341246290801,2.05341246290801,1.82120432440251,86,73,175,0.430584669113159,2.11949685534591,1.35887096774194,2.89112903225806,248,159
"1200",100,21.5,12,349,753,0.0123999604782136,2.15759312320917,2.15759312320917,1.78717874239867,88,78,183,0.424523204565048,2.10240963855422,1.33716475095785,2.88505747126437,261,166
